com.tencent.mm	微信
com.tencent.mobileqq	QQ
com.ss.android.ugc.aweme	抖音短视频
com.baidu.searchbox	百度
com.smile.gifmaker	快手
com.tencent.tmgp.sgame	王者荣耀
com.baidu.homework	作业帮-学生搜题利器
com.tencent.tmgp.pubgmhd	和平精英
com.netease.cloudmusic	网易云音乐
com.qiyi.video	爱奇艺
com.tencent.qqmusic	QQ音乐
com.kugou.android	酷狗音乐
com.tencent.qqlive	腾讯视频
tv.danmaku.bili	哔哩哔哩
com.taobao.taobao	手机淘宝
com.tencent.mtt	QQ浏览器-便捷管理手机文件
com.xunmeng.pinduoduo	拼多多
com.ss.android.article.video	西瓜视频
com.ss.android.article.news	今日头条
com.ximalaya.ting.android	喜马拉雅
com.sina.weibo	新浪微博
com.A17zuoye.mobile.homework	一起小学学生
com.baidu.netdisk	百度网盘
com.autonavi.minimap	高德地图
com.youku.phone	优酷视频
com.youdao.dict	网易有道词典-英语学习翻译
com.fenbi.android.solar	小猿搜题
com.zhihu.android	知乎
com.jiongji.andriod.card	百词斩
com.tencent.karaoke	全民K歌
com.kuaiduizuoye.scan	快对作业
com.xueersi.parentsmeeting	学而思网校
com.kmxs.reader	七猫免费小说
com.tencent.tmgp.cf	穿越火线-枪战王者（国民枪战手游）
com.skyplatanus.crucio	快点
com.ss.android.ugc.live	抖音火山版(原火山小视频)
cn.kuwo.player	酷我音乐
com.tencent.KiHan	火影忍者
com.jifen.qukan	趣头条
com.kuaikan.comic	快看漫画
com.baidu.BaiduMap	百度地图
com.baidu.haokan	好看视频
com.mallestudio.gugu.app	触漫
com.tencent.tmgp.speedmobile	QQ飞车手游
com.ztgame.bob	球球大作战
com.tencent.news	腾讯新闻-打开眼界
com.jingdong.app.mall	京东
com.mt.mtxx.mtxx	美图秀秀
com.duokan.reader	多看阅读
com.plan.kot32.tomatotime	番茄ToDo
com.sencent.mm	名人朋友圈
cn.xuexi.android	学习强国
com.huiian.timing	Timing
com.youdao.translator	有道翻译官
com.kingsoft	金山词霸
com.xingin.xhs	小红书
com.baidu.baidutranslate	百度翻译（语音翻译）
com.yuantiku.tutor	猿辅导
com.mewe.wolf	饭局狼人
com.jzzs.ParentsHelper	安全教育平台
com.jinxin.namibox	纳米盒
com.jm.video	刷宝
com.meitu.meipaimv	美拍
com.qqgame.hlddz	欢乐斗地主（腾讯）
com.yangcong345.android.phone	洋葱学院（原洋葱数学）
com.lofter.android	LOFTER
com.lemon.faceu	Faceu激萌
com.liulishuo.engzo	流利说-英语
com.banciyuan.bcywebview	半次元
com.tencent.weread	微信读书
org.xinkb.blackboard.android	晓黑板
com.ks.kaishustory	凯叔讲故事
net.huanci.hsj	画世界
com.duwo.reading	伴鱼绘本
com.campmobile.snowcamera	B612咔叽
com.haowan.huabar	画吧
com.gorgeous.lite	轻颜相机
zwzt.fangqiu.edu.com.zwzt	纸条
com.hypergryph.arknights	明日方舟
com.taobao.idlefish	闲鱼
cn.xiaochuankeji.tieba	最右
com.iflytek.elpmobile.smartlearning	智学网
com.happyteam.dubbingshow	配音秀
com.haojiazhang.activity	小学宝
com.knowbox.rc.student	小盒学生
com.duowan.kiwi	虎牙直播
cn.cntv	央视影音
com.tencent.qqlivekid	小企鹅乐园
com.gaotu100.superclass	高途课堂
com.mobike.mobikeapp	摩拜单车
com.xiaoenai.app	小恩爱
com.sinovatech.unicom.ui	联通手机营业厅(官方版)
com.kekeclient_	可可英语
fm.xiami.main	虾米音乐
com.ishowedu.peiyin	英语趣配音
com.yibasan.lizhifm	荔枝
com.mistong.ewt360	升学e网通
com.sdu.didi.psnger	滴滴出行
com.qidian.QDReader	起点读书
com.ekwing.students	翼课学生
com.hunantv.imgo.activity	芒果TV
com.ygkj.chelaile.standard	车来了-精准实时公交
fm.qingting.qtradio	蜻蜓FM
com.tencent.wework	企业微信
com.join.android.app.mgsim.wufun	悟饭游戏厅
com.gotokeep.keep	Keep
com.baidu.tieba	百度贴吧
com.wuba	58同城 -租房招聘兼职二手车
com.chaozh.iReaderFree	掌阅
com.jingyao.easybike	哈啰出行
com.hongen.app.word	洪恩识字
com.shizhuang.duapp	得物(毒)
com.student.yuwen.yimilan	一米阅读
me.ele	饿了么
com.sinyee.babybus.talk2kiki	宝宝巴士奇妙屋
com.videogo	萤石云视频
com.fenbi.android.leo	小猿口算
com.qq.reader	QQ阅读-小说漫画电子书阅读器
com.mygolbs.mybus	掌上出行
com.moji.mjweather	墨迹天气
com.hupu.shihuo	识货
cmccwm.mobilemusic	咪咕音乐
com.qq.ac.android	腾讯动漫
com.tencent.qqgame.xq	天天象棋
com.dedao.juvenile	少年得到
com.mengtuiapp.mall	萌推
com.foundersc.app.xf	小方客户端
bubei.tingshu	懒人听书FM-电台小说收音机
com.meitu.meiyancamera	BeautyCam美颜相机
com.hpbr.bosszhipin	Boss直聘
com.kingpoint.gmcchh	广东移动手机营业厅
com.sinyee.babybus.recommendapp	宝宝巴士
com.duitang.main	堆糖
com.benqu.wuta	无他相机
com.tencent.ttpic	天天P图
com.baicizhan.ireading	百词斩爱阅读
com.qb.qtranslator	腾讯翻译君
com.duoduo.child.story	儿歌多多
com.sfacg	菠萝包轻小说
com.taobao.mobile.dipei	口碑
cn.com.langeasy.LangEasyLexis	不背单词
com.xiaobanlong.main	小伴龙
com.tencent.weishi	微视-短视频创作与分享
com.netease.vopen	网易公开课
com.tencent.androidqqmail	QQ邮箱
com.greenpoint.android.mc10086.activity	中国移动
cn.paperang.mm	喵喵机
com.shoujiduoduo.ringtone	铃声多多
com.cmcc.cmvideo	咪咕视频
com.jjwxc.reader	晋江小说阅读
com.cubic.autohome	汽车之家
com.genshuixue.student	跟谁学
com.ishowedu.child.peiyin	少儿趣配音
com.bokecc.dance	糖豆
cn.kuwo.tingshu	酷我畅听
com.shanbay.sentence	扇贝单词英语版
com.maimemo.android.momo	墨墨背单词
com.yw.kidsongs	儿歌千千
com.chinamworld.main	中国建设银行
com.pengda.mobile.hhjz	叨叨记账
com.sainti.eduread	出口成章
com.zhongduomei.rrmj.society	人人视频
com.mampod.ergedd	儿歌点点
com.kwai.videoeditor	快影
com.achievo.vipshop	唯品会
air.tv.douyu.android	斗鱼直播
cn.ninegame.gamemanager	九游
com.songheng.eastnews	东方头条
cn.xckj.talk_junior	伴鱼少儿英语
com.qihoo.qeditor	快剪辑
com.hujiang.hjclass	沪江网校
tv.yixia.bobo	波波视频
com.tencent.map	腾讯地图
com.MobileTicket	铁路12306
com.bluedancer.bluedancer	蓝舞者
com.xfanread.xfanread	樊登小读者
com.didapinche.booking	嘀嗒出行
com.ushaqi.zhuishushenqi	追书神器
com.lingan.seeyou	美柚-大姨妈月经期助手
ai.zuoye.app	爱作业
com.qingclass.jgdc	极光单词
com.vanthink.student	在线助教学生
com.taobao.trip	飞猪
com.ophone.reader.ui	咪咕阅读
com.wuba.zhuanzhuan	转转
cn.jj	JJ斗地主
com.xiaohaizi.ui	小孩子点读
com.zebra.ichess	国象联盟
com.zmlearn.course.am	掌门1对1辅导
enfc.metro	亿通行
com.android.dazhihui	大智慧
com.netease.uu	网易UU加速器
ctrip.android.view	携程旅行迪士尼酒店机票火车票旅游门票攻略团购
com.ct.client	电信营业厅
com.physicmaster	物理大师
com.tencent.k12	腾讯企鹅辅导
com.vmall.client	华为商城
com.tencent.firevideo	火锅视频
com.dreamtd.kjshenqi	激萌猫咪桌面宠物
com.shinyv.cnr	云听
com.chinamworld.bocmbci	中国银行手机银行
com.tencent.qqpinyin	QQ输入法
com.color.by.number.paint.ly.pixel.art.cn	Paint.ly
com.sohu.sohuvideo	搜狐视频-电影电视剧美剧影音视频播放器
com.yunshuxie.main	云舒写
com.gh.gamecenter	光环助手
com.lexue100	乐学一百
com.ifeng.news2	凤凰新闻
com.baidu.wenku	百度文库
com.pplive.androidphone	PP视频（原聚力视频）
com.netease.cc	CC直播
cn.etouch.ecalendar	中华万年历
com.yuewen.authorapp	作家助手
com.tencent.qgame	企鹅电竞
com.xiachufang	下厨房
com.youdao.reciteword	有道背单词
com.hexin.plat.android	同花顺手机炒股股票软件
com.eusoft.eudic	欧路词典
com.hfjy.LearningCenter	海风智学中心
com.douban.frodo	豆瓣
com.newcapec.mobile.ncp	完美校园
com.kugou.android.ringtone	酷狗铃声
com.xiaomi.shop	小米商城
com.xtuone.android.syllabus	超级课程表
org.wanmen.wanmenuni	万门大学
com.ants360.yicamera	小蚁摄像机
com.starbucks.cn	星巴克
com.sinyee.babybus.automobilecity	宝宝巴士汽车城
com.mumars.student	微博士家长端
com.vipabc.vipmobilejr	vipjrHD
com.alo7.android.student	爱乐奇
com.hhdd.kada	KaDa故事
cn.wsds.gamemaster	迅游手游加速器
com.codoon.gps	咕咚
cn.dict.android.pro	海词词典
com.oray.sunlogin	向日葵远程控制
com.babycloud.hanju	韩剧TV
cn.TuHu.android	途虎养车
com.vipkid.app	VIPKID英语
com.smzdm.client.android	什么值得买
com.netease.newsreader.activity	网易新闻（官方）
com.tal.kaoyan	考研帮
com.lovebizhi.wallpaper	爱壁纸_桌面锁屏
co.runner.app	悦跑圈
com.seebaby	掌通家园
com.zhuoyue.z92waiyu	92外语
com.shiqichuban.android	拾柒
com.alibaba.wireless	阿里巴巴
com.hujiang.cctalk	CCtalk
com.tianqi2345	2345天气预报
com.qihoo.video	360影视大全
com.towords	拓词-上瘾背单词
doctorjob.com.cn	中国医疗人才网
com.bilibili.comic	哔哩哔哩漫画
com.tencent.game.rhythmmaster	节奏大师
com.tencent.qt.qtl	掌上英雄联盟
cn.com.cmbc.newmbank	民生银行手机银行
com.lejent.zuoyeshenqi.afanti	阿凡题
com.baicizhan.dict	百词斩词典
com.fxicrazy.sjml	联掌门户
com.btsj.hpx	百通医学
com.hustzp.com.xichuangzhu	西窗烛
com.meishubao.client	美术宝
com.xinhang.mobileclient	河南移动智慧生活
com.css.bj.css	爱课程
com.lucky.luckyclient	luckincoffee
com.sprite.foreigners	傻瓜英语
com.msyc.onion	洋葱OMALL
com.shoujiduoduo.wallpaper	壁纸多多
com.up366.mobile	天学网
com.scho.manager	掌上学院
com.mistong.kklonline.kklonline	开课啦直播
sina.mobile.tianqitong	天气通
com.danale.video	大拿
com.xjlmh.classic	小妖精美化
com.baidu.yuedu	百度阅读
com.bankcomm.Bankcomm	交通银行
com.duolingo	多邻国免费学英语
com.bmcc.ms.ui	北京移动手机营业厅
com.tsingzone.questionbank	一起考教师
com.koolearn.english.donutabc	新东方多纳
com.kq.kq36.com	康强医疗人才网
com.hanfuhui	汉服荟
com.cheetah.stepformoney	走多多
com.qq.qcloud	微云
com.jd.jrapp	京东金融
com.kunpeng.babyting	宝贝听听
com.p1.mobile.putong	探探
com.appshare.android.ilisten	口袋故事
com.ihuman.imath	洪恩数学
com.youdao.note	有道云笔记
com.handsgo.jiakao.android	驾考宝典-驾照考试|驾校理论
com.tiqiaa.icontrol	遥控精灵
com.tencent.cldts	光荣使命：使命行动
com.hupu.games	虎扑
com.coolapk.market	酷安
com.daofeng.zuhaowan	租号玩
cn.soulapp.android	Soul
com.qzone	QQ空间
com.zhengnengliang.precepts	正气
com.by.butter.camera	黄油相机
com.futurefleet.dongguantongbus.ui.dg	东莞通
com.jiandan.mobilelesson	简单课堂
cn.vcinema.cinema	南瓜电影
com.tan8	弹琴吧
com.lptiyu.tanke	步道乐跑
cn.weli.story	微鲤看看
com.chinarainbow.tft	天府通
com.tencent.reading	看点快报
com.sina.news	新浪新闻
com.suning.mobile.ebuy	苏宁易购
com.shangfang.gylm	高佣联盟
com.nineton.weatherforecast	新晴天气
com.ailian.hope	hope
com.android.bankabc	农行掌上银行
com.job.android	前程无忧51Job
cn.myhug.tiaoyin	耳觅
com.baidu.iknow	百度知道
com.xqw369.ttsz	天天识字
com.Qunar	去哪儿旅行-酒店.火车
com.wudaokou.hippo	盒马
com.wisemen.hhb	慧话宝
com.changba	唱吧音视频
com.wenba.bangbang	学霸君-作业答疑帮手
com.keji.lelink2	联想看家宝
com.znxh.hyhuo	火萤视频壁纸
com.tencent.qqsports	腾讯体育-中超英超直播
com.zhaopin.social	智联招聘
com.mistong.opencourse	开课啦
com.rj.syslearning	同步学
com.dangdang.buy2	当当
cn.danatech.xingseapp	形色
com.joinfonet.atx	爱听写
com.sogou.novel	搜狗阅读
com.cmcc.gs	和陇原
com.sunrise.scmbhc	四川移动掌上营业厅
com.duia.app.Putonghua	普通话学习测试
com.wm.dmall	多点
com.suma.gztong	贵州通
com.gdcn.sport	群体通
com.yyxx.study	语音学习系统
com.yixinjiang.goodbaba.app.presentation.pep	好爸爸学习机版
com.dw.btime	亲宝宝
com.fenqile.fenqile	分期乐
com.zivn.cloudbrush3	书法字典大全
com.brt.mate	时光手帐Pro
com.sogou.toptennews	今日十大新闻
com.nice.main	nice
com.example.businesshall	手机营业厅
com.jx.cmcc.ict.ibelieve	和我信
cn.youth.news	中青看点
com.luojilab.player	得到
com.tmri.app.main	交管12123
com.black.unique	全球购骑士特权
com.tnscreen.main	多屏互动
cn.mama.pregnant	妈妈网孕育
com.denglin.moji	墨记
com.hunting.matrix_callershow	嗨来电
com.futurefleet.pandabus.ui.yx	宜兴享出行
cn.ledongli.ldl	乐动力
com.jxedt	驾校一点通
com.anjuke.android.app	安居客一二手房新房租房商铺
com.koalareading.koalareading	考拉阅读
com.mst.activity	宝安通
com.justjump.loop	Loop跳绳训练专业平台
com.wandafilm.app	万达电影
com.hongxiu.app	红袖读书
com.lanjiyin.xiyikaoyan	医学考研
com.caiyuninterpreter.activity	彩云小译
com.csii.tianjin.mobilebank	天津银行
com.lanjingren.ivwen	美篇
com.mengjun.DanNovel	书耽免费耽美小说
com.netease.yanxuan	网易严选
com.qingdaonews.bus	青岛公交查询
com.qmtt.qmtt	启蒙听听儿歌故事
com.alpha.lagouapk	拉勾招聘
com.cqmc.client	重庆移动
com.app.shanghai.metro	Metro大都会
cn.caocaokeji.user	曹操出行
com.biku.diary	青柠手帐
com.sitech.ac	移动惠生活
cn.missfresh.application	每日优鲜
com.razkidscamb.americanread.android.architecture.newrazapp	RAZ课堂
com.mxr.dreambook	4D书城
com.spark.peak	巅峰训练
com.crgt.ilife	掌上高铁
com.zhaowen.caocao	曹操讲作文
com.zaijia.xiaodu	小度在家
com.baidu.minivideo	全民小视频
com.tencent.tmgp.xinhuluwa	葫芦娃
com.cheersedu.app	湛庐阅读
com.pocket.snh48.activity	口袋48
com.sohu.newsclient	搜狐新闻
com.tbkt.student	同步课堂学生
com.gzyct.yctwallet	羊城通
com.tencent.rijvideo	看点视频-腾讯看点短视频，年轻人都爱看
com.alibaba.android.rimet	钉钉
com.UCMobile	UC浏览器
com.tencent.tmgp.qjnn	奇迹暖暖
com.taptap	TapTap
sogou.mobile.explorer	搜狗浏览器
com.fenbi.android.zenglish	斑马AI课（原斑马英语）
com.qihoo.appstore	360手机助手
com.tencent.tmgp.WePop	跑跑卡丁车官方竞速版
com.picsart.studio	PicsArt
com.tencent.tmgp.dwrg	第五人格（生存类独立游戏）
com.wukongtv.wkremote.client	悟空遥控器
com.sogou.activity.src	搜狗搜索
com.tencent.game.SSGame	天天飞车
com.psyone.brainmusic	小睡眠
cn.ticktick.task	滴答清单
com.tencent.wemeet.app	腾讯会议
com.happyelements.AndroidClover.www	海滨消消乐-建造岛屿
com.happyelements.AndroidAnimal.qq	开心消消乐-限时有礼
com.tencent.peng	天天爱消除（阿童木版）
com.lianjia.beike	贝壳找房一租房新房二手房
com.autonavi.cmccmap	和地图
com.huajiao	花椒直播
com.kaola	考拉海购
com.xiaoying.cardloan	小赢卡贷
com.huawei.health	华为运动健康
com.dinoenglish.yyb	E英语宝
com.mosoink.teach	云班课
com.deskmate100	同桌100
com.njh.biubiu	BiuBiu加速器
com.songwo.pig	阳光养猪场
com.blueberry.lxwparent	蓝小咪
com.ximalaya.ting.kid	喜马拉雅儿童
com.ivydad.readtool	常青藤爸爸早教
air.com.gongfubb.wksz	悟空识字
com.meijiale.macyandlarry	优教信使
com.c2vl.kgamebox	口袋狼人杀
com.duowan.mobile	YY
com.youdao.kiddict	有道少儿词典
jyeoo.app.ystudy	菁优网
com.broaddeep.discipline	阳光自律
com.tencent.wifimanager	WiFi管家—轻松连上好wifi
com.qingqi.dianbo	微光
com.power.dapengeducation	大鹏教育
com.jiliguala.niuwa	叽里呱啦
com.tencent.fifamobile	FIFA足球世界
com.iflytek.oshall.ahzwfw	皖事通
cn.tc.umu	UMU互动
com.android.weici.senior.student	维词
com.dotreader.dnovel	点阅小说
cn.com.gridinfo	12xue学生
com.zy.course	果肉网校
com.meta.xyx	233小游戏
cn.com.igdj.shopping	云校通
com.strong.letalk	乐桃
com.spero.vision.vsnapp	股拍
com.tencent.LEGOCUBE	乐高无限
com.xiaomi.xiaoailite	小爱同学
com.wondertek.miguaikan	咪咕爱看
com.wumii.android.athena	一点英语
cn.zepeto.main	崽崽ZEPETO
com.ailide.apartmentsabc	爱立熊
com.rockets.chang	唱鸭
com.flash.matrix_wallpaper	闪动壁纸
com.tencent.nijigen	波洞-腾讯旗下动漫互动社区
com.xiaoxun.xun	小寻
com.iflytek.vflynote	讯飞语记
com.netease.play	LOOK直播
com.huabenapp	话本小说
com.tsy.tsy	淘手游
com.wisedu.cpdaily	今日校园
com.caniculab.musical	弹唱达人
com.tuoluo.shijie	陀螺世界
com.cameras.prettygirls	装扮少女
cn.dictcn.android.digitize.swg_xhzd_21003	新华字典
com.yueyou.adreader	阅友免费小说
com.pcncn.jj	作业精灵
com.cootek.crazyreader	疯读小说
com.chaozh.iReader.dj	得间免费小说
com.wsecar.wsjcsj	万顺车主
com.aijiao100.study	百分课堂
com.weibo.comic	微博动漫
com.sogou.translator	搜狗翻译
com.gj_1bbmm.primaryenglish	小学英语人教版
com.wepie.weplay	会玩
tv.acfundanmaku.video	AcFun
com.zjy.ykt	云课堂智慧职教
com.uxin.kilanovel	克拉有读
com.focustech.android.mt.parent	焦点家校
com.hipu.yidian	一点资讯
com.zhan.ieltstiku	小站雅思
com.ainemo.dragoon	小鱼易连
com.qicaibear	七彩熊绘本
com.huodao.hdphone	找靓机
com.jiayouya.travel	旅行世界
com.medibang.android.paint.tablet	MediBangPaint
com.shuqi.controller	书旗小说
com.pnlyy.pnlclass.pnlclass_student	VIP陪练
com.camerasideas.instashot	InShot视频和照片编辑软件
com.sup.android.superb	皮皮虾
com.bilibili.qing	轻视频
com.nd.app.factory.sdev	网教通
cn.ait.tsk.student	爱老师学生端
com.cliff	藏书馆
com.google.android.apps.translate	Google翻译
com.kamitu.drawsth.standalone.free.android	疯狂猜成语
com.nfdaily.nfplus	南方Plus
com.ttxmzq.pandamakemoney.asjz	爱上兼职
love.match.set	爱上消消消
c.l.a	闪电盒子
com.soufun.app	房天下一新房二手房租房买房搜房房价
com.online.xthk	心田花开在线
com.qinlin.ahaschool	Ahaschool
com.naver.linewebtoon.cn	咚漫
com.pedometer.money.cn	欢乐走
com.netease.gl	网易大神
com.liansong.comic	小鸡漫画
com.esread.sunflowerstudent	向日葵阅读
com.tiantianaituse	漫芽糖
com.hht.bbparent	爱学班班家长端
com.unnoo.quan	知识星球
com.faloo.BookReader4Android	飞卢小说
com.liulishuo.sprout	流利说-少儿英语
com.qsmy.walkmonkey	步多多
com.dragon.read	番茄免费小说
com.snda.wifilocating	WiFi万能钥匙
com.tencent.tim	TIM-QQ办公简洁版
com.le123.ysdq	影视大全
com.cctv.yangshipin.app.androidp	央视频
com.seewo.easicare.pro	班级优化大师
com.cmcc.android.ysx	云视讯
com.sofunny.Sausage	香肠派对
com.team108.xiaodupi	小肚皮
com.fenbi.android.gaozhong	猿题库
com.xmcy.hykb	好游快爆
cn.gzmovement	动静新闻
com.net.zdsoft.netstudy.netstudy_v5_mobile_app	课后网
com.suirui.zhumu	瞩目
com.yunxiao.haofenshu	好分数
com.yiyou.ga	TT语音
com.m4399.gamecenter	4399游戏盒
com.broaddeep.safe.parents	阳光守护
com.yuncheapp.android.pearl	快看点-快手视频赚钱
com.tencent.edu	腾讯课堂
com.shensz.student	一起作业中学学生端
com.pep.diandu	人教点读
com.yiqizuoye.jzt	一起学
cn.eeo.classin	ClassIn
cn.xdf.roombox.app	新东方云教室
com.knowbox.rc.student.pk	小盒家长
com.xes.jazhanghui.activity	学而思培优
com.zybang.parent	作业帮口算
com.zhl.fep.aphone	闽教学习
com.kwai.sogame	快手小游戏
com.bjhl.weishi	微师
com.immomo.momo	MOMO陌陌
com.kooup.student	新东方在线中小学
com.intsig.camscanner	扫描全能王
cc.septnet.scholar	小七学伴
com.lechuan.midunovel	米读小说
com.zhy.qianyan	浅言
com.ichano.athome.avs	掌上看家采集端
com.tongxue.tiku	学而思轻课
com.youdao.course	有道精品课
com.leleketang.SchoolFantasy	天天练
com.netease.edu.ucmooc	中国大学MOOC
com.yqxue.yqxue	一起学网校
com.bestv.app	BesTV
com.qihoo.haosou.subscribe.vertical.book	小书亭
com.hcj.gznews	花城+
com.qihoo360.antilostwatch	360儿童卫士
net.qihoo.launcher.widget.clockweather	360天气
com.h4399.gamebox	4399在线玩
com.youloft.calendar	51万年历
com.win100edu.a100	A100教学
com.pandaabc.stu	爱课少儿英语学生端
com.sand.airdroid	AirDroid
com.androidesk	安卓壁纸-含动态壁纸
com.mszmapp.detective	百变大侦探
com.baidu.baike	百度百科
cn.opda.a.phonoalbumshoushou	百度手机卫士
com.duwo.phonics	伴鱼自然拼读
com.bruce.english	宝宝学英语
com.nwoolf.xy.b500	北师大小学数学全集
com.lwby.breader.ad	必看免费小说
com.bishen.zuowen	笔神作文
com.xunruifairy.wallpaper	壁纸精灵
com.poooli.printer	啵哩
cn.boyakids.m	博雅小学堂
tv.buka.android	布卡互动
com.tencent.ttcaige	猜歌星球
com.cainiao.wireless	菜鸟裹裹
cn.cntvnews	央视新闻
io.moreless.tide	潮汐
com.sixrpg.opalyer	橙光
com.lion.market	虫虫助手
com.kuangxiangciweimao.novel	刺猬猫阅读
io.dcloud.H514D19D6	代练通
tv.dasheng.vs	大圣电竞
com.energysh.onlinecamera1	大神P图
com.mop.gproverb	答题夺宝
DDT.QQ78551393	点读通
tv.tvguo.androidphone	电视果
com.diyidan	第一弹
com.eastmoney.android.berlin	东方财富
com.freshpower.android.college	e电工云课堂
io.dushu.fandengreader	樊登读书
com.okay.jx	方象
az.studio.gkztc	高考直通车
com.wiseman.writing	跟我学写汉字
com.kk.poem	古诗词典
org.gushiwen.gushiwen	古诗文网
com.hisense.ms.fly2tv	海信聚好看
com.haoyisheng.mobile.app	好医生
com.xxt.jxlxandroid	河南校讯通
com.ihuman.english	洪恩儿童英语
com.ihuman.story	洪恩故事
com.huaban.android	花瓣
com.i61.dengta	画啦啦小灯塔
com.calendar.UI	黄历天气
com.huanxiongenglish.flip	浣熊学堂
com.yuanlue.chongwu	互动桌面宠物
com.saker.app.huhu	呼呼收音机
com.hp.printercontrol	惠普移动打印
jp.ne.ibis.ibispaintx.app	ibisPaint X
com.maiya.weather	简单天气
com.jym.mall	交易猫
com.jingdong.pdj	京东到家
com.founder.chenzhourb	今日郴州
com.cdvcloud.maanshan	今日马鞍山
com.liziyuedong.goldpig	金猪生大钱
com.game.matrix_pixelpaint	开心图图乐
com.openlanguage.kaiyan	开言英语
com.kanlixiang.android	看理想
com.kpl.student	快陪练
com.dewmobile.kuaiya	快牙
com.letv.android.client	乐视视频
com.zenmen.palmchat	连信
com.feiteng.lieyou	猎游
com.lizhiweike	荔枝微课
com.screeclibinvoke	录屏大师
com.sina.oasis	绿洲
cn.missevan	猫耳FM
com.yongloveru.hjw	每天赚点
com.mengzhu.app	盟主
cn.emagsoftware.gamehall	咪咕快游
com.xmeng.mrddz	明日斗地主
com.motk	魔题库
com.nd.android.pandareader	熊猫看书
com.pingan.papd	平安好医生
com.pipipifa.pilaipiwang	批批网服装女装批发
com.tencent.kapu	卡噗
com.edu.android.daliketang	清北网校
com.gumi.spokenenglish	人教口语
com.yunti.zzm	书链
com.teambition.teambition	teambition
com.fundubbing.dub_android	天天配音
com.tianyancha.skyeye	天眼查
com.tongyi.edu	统一教育
cn.neoclub.uki	Uki
video.vue.android	VUEVlog
com.netease.buff	网易BUFF游戏饰品交易平台
com.netease.snailread	网易蜗牛读书
com.planet.light2345	玩赚星球
com.xiaodu.smartspeaker	小度音箱
com.ukids.client.phone	小小优趣
com.pdmi.guangzhou.media	新花城
com.sj4399.gamehelper.hpjy	4399和平精英助手
com.app.bfb	爱客宝
com.mosheng	陌声
com.aixuetang.online	爱学堂
com.video.v8090	火趣小视频
com.video.kd	快逗短视频
com.bruce.baby	宝宝爱识字
com.husor.beidian	贝店
cn.itvsh.bobotv	播播TV
com.glodon.drawingexplorer	CAD快速看图
cn.canva.editor	Canva
net.cpwxw.cpfiction	长佩阅读
com.yusi.chongchong	虫虫钢琴
com.qmyl.qifei	全民养龙
com.tencent.tmgp.shoufutefannaoo	首富特烦恼
com.sdbean.werewolf	天天狼人
com.sportq.fit	Fit
com.yitong.fjnx.mbank.android	福建农村信用社手机银行客户端
com.iqiyi.comic	爱奇艺漫画
cn.cty.hbzw	鄂汇办
com.zhangyangjing.starfish	海星模拟器
cn.com.gxrb.client	广西云
com.yy.huanju	Hello
com.founder.maanshan	马上app
net.evecom.android.mztapp	闽政通
com.fdcxxzx.xfw	选房网
com.jtcloud.teacher	京版云
com.hexin.plat.android.ZhongyuanSecurity	中原证券财升宝
cn.lezhi.speedtest	网速管家
com.xuanke.kaochong	考虫
cn.igxe	IGXE
cn.com.htjc.pay	电e宝
com.yek.android.kfc.activitys	肯德基
com.inpor.fastmeetingcloud	好视通云会议
com.kugou.fanxing	酷狗直播
com.laixue.lxagent	来学宝典
com.joyshow.joyshowcampus	乐现云课堂
com.lianaibiji.dev	恋爱记
com.sl.whale	鲸鸣
com.languo.memory_butler	记忆管家
cn.memobird.app	Memobird咕咕机
com.uxin.live	克拉克拉
com.mobile.kadian	卡点视频制作
com.myxianwen.nanguozaobao	南国早报
com.wutongtech.climbingreading	攀登阅读
com.mendon.riza	日杂相机
com.tudao.RobotMake	RobotMake机器人控制软件
com.jsmcc	掌上营业厅
com.zdworks.android.zdclock	正点闹钟
com.auramarker.zine	Zine
com.aixuexi.gushi	爱学习古诗
com.tencent.tmgp.wooduan.ssjj	生死狙击
com.annie.annieforchild	安妮花
science.bigkexue.com	大科学
com.sogou.androidtool	搜狗手机助手
com.togic.livevideo	泰捷视频
com.dd.dingdonglive	叮咚课堂
com.wepie.snake.tencent	贪吃蛇大作战
com.gfs.android.highscoretalk	高分说新版
com.iyuba.TEDVideo	TED英语演讲
com.tencent.now	腾讯NOW直播-附近美女真人视频聊天
com.i61.draw.live	画啦啦VIP课堂
com.huatu.handheld_huatu	华图在线
com.textbookmaster.publisher.cn	课本通小学语文学习平台
com.seblong.idream	蜗牛睡眠
com.wzf.fan	我是谜
com.unicom.woshipin	沃视频
com.izaodao.gps	五十音图
com.infinitus.bupm	无限极中国
com.xiangha	香哈菜谱
com.xnw.qun	校内外
com.aspirecn.xiaoxuntongParent.ln	辽宁和教育
edu.www.qsxt	青书学堂
com.rayclear.renrenjiang	人人讲
uni.UNI0EA15B0	书成课堂
com.yiche.autoeasy	易车
com.yuedong.sport	悦动圈
com.dalongtech.cloud	云电脑
com.imaginer.yunji	云集
com.lizi.yuwen	语文100分
com.huayi.cme	掌上华医
com.hexinedu.sigma.assistant	外研AI学习版
com.xiyou.english	西柚英语
com.zero.xbzx.student	学霸在线
com.xuexiaoyi.xxy	学小易
com.zgxt.app	诸葛学堂
com.z.hhwk	作业互助组
com.xiaoshijie.sqb	好省
cn.gloud.client.mobile	格来云游戏客户端
com.pa.health	平安健康
com.up360.parents.android.activity	向上网
cn.com.enorth.jinyun	津云
dopool.player	手机电视
com.sflep.course	WElearn随行课堂
com.wanhe.eng100.listening	听力百分百
com.zstv	中山手机台
com.ablesky.ui.activity	能力天空
com.ss.readpoem	为你诵读