com.chinasofti.rcs	fetion
com.tencent.mobileqq	qq
com.tencent.mm	weixin
com.immomo.momo	momo
im.yixin	yixin
com.alibaba.android.rimet	dingding
com.xiaoenai.app	xiaoenai
com.liaoliao.android	liaoliao
cn.soulapp.android	soul
com.tencent.wework	qiyeweixin
com.zenmen.palmchat	lianxin
com.tencent.tim	tim
com.Tiange.ChatRoom	9158meinvzhibo
us.zoom.videomeetings	zoom
com.ophone.reader.ui	heyuedu
com.qidian.QDReader	qidianzhongwen
com.nd.android.pandareader	panda.book
com.qq.reader	qq.read
com.zongheng.reader	zonghengxiaoshuo
com.chaozh.iReaderFree	iReader
com.jjwxc.reader	jinjiangwenxuecheng
com.xxsyread	xiaoxiangshuyuan
com.hongxiu.app	hongxiutianxiang
com.esbook.reader	yisouxiaoshuo
com.netease.pris	163yunyuedu
com.shuqi.controller	shuqixiaoshuo
com.duokan.reader	duokanyuedu
com.baidu.yuedu	baiduyuedu
qsbk.app	qiushibaike
com.ushaqi.zhuishushenqi	zhuishushenqi
com.lectek.android.sfreader	tianyiyuedu
com.unicom.zworeader.ui	woyuedu
com.sogou.novel	sougouyuedu
com.itangyuan	tangyuanchuangzuo
com.wifi.reader	lianshangdushu
com.tencent.weread	weixindushu
com.comic.shenmanhua	shenmanhua
com.skyplatanus.crucio	kuaidianyuedu
com.smartisan.reader	chuiziyuedu
com.cnki.client	shoujizhiwang
net.csdn.csdnplus	csdn
com.faloo.BookReader4Android	feiluxiaoshuo
com.student.yuwen.yimilan	yimiyuedu
com.dz.mfxsqj	mianfeixiaoshuoquanji
com.martian.ttbook	taoxiaoshuo
com.fengwo.reading	youshu
cc.quanbennovel	quanbenmianfeikuaiduxiaoshuo
cc.kdqbxs.reader	mianfeiquanbenxiaoshuoshucheng
com.btime.bjtime	beijingshijian
com.cheersedu.app	zhanluyuedu
com.myxianwen.nanguozaobao	nanguozaobao
com.bookuu.bookuulibrary	bokutushuguan
com.cliff	cangshuguan
com.tataera.rtxtbook	quanbenmianfeidianzixiaoshuo
cn.com.weilaihui3	weilai
com.duokan.freereader	miyuexiaoshuo
com.hustzp.com.xichuangzhu	xichuangzhu
cn.com.enorth.jinyun	jinyun
com.ailian.hope	hope
com.lechuan.midunovel	miduxiaoshuo
com.sfacg	boluobaoqingxiaoshuo
net.xinhuamm.mainclient	xinhuashe
com.nfdaily.nfplus	nanfangplus
com.jiemian.news	jiemianxinwen
com.hisunflytone.android	miguquanquan
cn.memobird.app	memobirdguguji
com.sobey.cloud.view.jiangxi	shoujijiangxitai
com.iflytek.readassistant	xunfeiyousheng
com.kmxs.reader	qimaomianfeixiaoshuo
tech.caicheng.judourili	judu
com.qihoo.haosou.subscribe.vertical.book	xiaoshuting
com.dangdang.reader	dangdangyunyuedu
com.mengjun.DanNovel	shudandanmeixiaoshuo
net.cpwxw.cpfiction	changpeiyuedu
com.yanhui.qktx	qukantianxia
com.immomo.mread	manduxiaoshuo
com.allhistory.dls.marble	quanlishi
club.modernedu.lovebook	aijiadushuhui
com.dragon.read	fanqiexiaoshuo
com.cootek.crazyreader	fengduxiaoshuo
com.qiyi.video.reader	aiqiyimianfeiyuedu
com.yueyou.adreader	yueyoumianfeixiaoshuo
com.dotreader.dnovel	dianyuexiaoshuo
com.huabenapp	huabenxiaoshuo
com.chaozh.iReader.dj	dejianmianfeixiaoshuo
com.uxin.kilanovel	kelayoudu
com.esread.sunflowerstudent	xiangrikuiyuedu
com.netease.snailread	wangyiguaniudushu
com.kuangxiangciweimao.novel	ciweimaoyuedu
com.lwby.breader.ad	bikanmianfeixiaoshuo
com.sixrpg.opalyer	chengguang
com.duwo.phonics	banyuziranpindu
io.dushu.fandengreader	fandengdushu
com.shusheng.JoJoRead	jiaojiaoyueduke
com.yuewen.cooperate.reader.free	feidumianfeixiaoshuo
com.sogou.reader.free	sougoumianfeixiaoshuo
com.hmkj.xgks	xiaoguikuaisou
com.chaoui.mintreading	boheyuedu
com.touchtv.pinggu	pinggurongmei
com.feiyi.p21	dubaokanxueyingwen
com.putao.KidReading.bookbook	bubuyuedu
com.sdiread.kt.ktandroid	shidiandushu
com.book2345.reader	qimaojingpinxiaoshuo
cn.lieying.app.readbook	lieyingmianfeixiaoshuo
cc.quanben.novel	quanbenmianfeixiaoshuoyueduqi
com.taptech.doufu	doufuyuedu
com.chineseall.reader	17kxiaoshuo
com.douban.book.reader	doubanyuedu
com.jiasoft.swreader	anzhuodushu
com.myzaker.ZAKER_Phone	zakerxinwen
com.sina.weibo	sina.weibo
com.zhenai.android	zhenaiwang
cn.tianya.light	tianyashequ
com.qzone	qzone
com.jiayuan	shijijiayuan
com.douban.frodo	douban
com.baidu.tieba	baidutieba
cn.xiaochuankeji.tieba	zuiyou
com.welove520.welove	weiai
com.p1.mobile.putong	tantan
com.blackbean.cnmeach	duimian
com.taou.maimai	maimai
com.xingjiabi.shengsheng	taqu
com.xjlmh.classic	xiaoyaojingmeihua
club.sugar5.app	sugarsuge
com.aladdin.dangdang	dangdang2
com.vanke.activity	zhuzheer
com.aiyu.kaipanla	kaipanla
com.brt.mate	shiguangshouzhangpro
com.fenzotech.jimu	jimu
com.liveyap.timehut	shiguangxiaowu
cn.neoclub.uki	uki
com.pocket.snh48.activity	koudai48
club.jijigugu.yiguan	yiguan
com.duowan.gamevoice	yyshouyouyuyin
com.banciyuan.bcywebview	banciyuan
com.haowan.huabar	huaba
com.kkptech.kkpsy	kukupao
gov.pianzong.androidnga	ngawanjiashequ
com.wzf.fan	woshimi
com.mszmapp.detective	baibiandazhentan
com.huaban.android	huaban
my.maya.android	duoshan
com.uneed.yuni	yuni
com.innovation.driftbottle	yujianpiaoliuping
com.sina.oasis	lvzhou
me.yidui	yiduishipinxiangqinjiaoyou
com.mosheng	mosheng
com.yinpai	yinpai
com.mobilevoice.findyou	xunni-qumengtiezhishipinjiaoyou
com.mozhe.mzcz	mozhe
com.samsung.android.voc	gaileshishequ
cn.sharesmile.enjoychat	xiangliao
com.baihe	baihehunlianjiaoyou
com.smxxy.sc	xianshangsanmenxia
cn.ibuka.manga.ui	buqiamanhua
com.baidu.hi	baiduhi
com.autonavi.cmccmap	heditu
com.baidu.BaiduMap	baiduditu
com.sogou.map.android.maps	sougouditu
com.tencent.map	qqditu
com.autonavi.minimap	amap
im.xingzhe	xingzhe
com.ygkj.chelaile.standard	chelaile
com.yiqiditu.app	yiqikanditu
com.cmcc.cmvideo	he.video
com.youku.phone	youku
com.tencent.qqlive	qq.video
com.sohu.sohuvideo	sohu.video
com.letv.android.client	letv
com.hunantv.imgo.activity	mangguoTV
com.qiyi.video	aiqiyi
cn.cntv	cntv
com.m1905.mobilefree	m1905
com.baidu.video	baidu.video
com.tencent.weishi	weishi
com.netease.vopen	163gongkaike
com.qihoo.video	360yingshidaquan
com.smile.gifmaker	gifkuaishou
tv.danmaku.bili	bilibili
com.telecom.video	tianyichaogaoqing
air.tv.douyu.android	douyutv
tv.acfundanmaku.video	acfun
com.duowan.kiwi	huyazhibo
com.yixia.xiaokaxiu	xiaokaxiu
com.longzhu.tga	longzhuzhibo
com.com.baomihuawang.androidclient	baomihuashipin
com.wole56.ishow	woxiuyulezhibo
cn.colorv	caishi
com.videogo	yingshiyunshipin
tv.xiaoka.live	yizhibo
com.huajiao	huajiaozhibo
com.netease.cc	cczhibo
com.togic.livevideo	taijieshipin
com.bestv.app	bestv
com.ifensi.fansheadlines	fensiwang
com.babycloud.hanju	hanjuTV
com.kascend.chushou	chushouzhibo
com.ss.android.ugc.live	huoshanxiaoshipin
com.ss.android.article.video	xiguashipin
com.ss.android.ugc.aweme	douyin
com.cmcc.migutvtwo	miguzhibo
com.tencent.qqsports	tengxuntiyu
com.wali.live	xiaomizhibo
com.zbx.ct.tvzhibo	shoujidianshigaoqingzhibo
com.zhongduomei.rrmj.society	renrenshipin
com.znxh.hyhuo	huoying
tv.yixia.bobo	boboshipin
com.pplive.androidphone.sport	pptiyu
com.cmvideo.migumovie	miguyingyuan
com.kugou.fanxing	kugouzhibo
com.tencent.qgame	qiedianjing
com.wondertek.miguaikan	miguaikan
com.baidu.haokan	haokanshipin
dopool.player	shoujidianshi
cn.quicktv.androidpro	jinriyingshidaquan
com.inphase.itv	ishishi
cn.itvsh.bobotv	bobotv
com.qihoo.qeditor	kuaijianji
com.xiangzi.jukandian	jukandian
com.tencent.now	tengxunnowzhibo
com.kugou.android.ktvapp	kugouchangchang
com.melot.meshow	kkmeinvzhibo
com.tiange.miaolive	miaobomeinvzhibo
com.sumavision.sanping.gudou	gudoutv
cn.v6.sixrooms	shiliuzhibo
com.ifeimo.videoeditor	shipinjianjidashi
com.bluedancer.bluedancer	lanwuzhe
com.memezhibo.android	memezhibo
com.rumtel.mobiletv	wtvyingshidaquan
com.taobao.live	taobaozhibo
qsbk.app.remix	remaozhibo
cn.vcinema.cinema	nanguadianying
com.tnscreen.main	duopinghudong
com.qingqi.dianbo	weiguang
com.yueme.itv	xiaoyiguanjia
com.xunlei.kankan	kankanshipin
com.mifeng.ui	mifengzhibo
org.fungo.a8sport	a8tiyuzhibo
com.tencent.firevideo	yooshipin
cn.xiaochuankeji.zuiyouLite	pipigaoxiao
com.dianshijia.tvlive	dianshijia
com.jm.video	shuabao2
com.unicom.woshipin	woshipin2
com.baidu.minivideo	quanminxiaoshipin
com.tencent.rijvideo	kandianshipin
com.meelive.ingkee	yingke
com.cctv.yangshipin.app.androidp	yangshipin
com.duowan.mobile	yywaiwai
com.le123.ysdq	yingshidaquan2
sg.bigo.shrimp	pipixie
com.cmcc.android.ysx	yunshixun
com.netease.play	lookzhibo
com.bilibili.qing	qingshipin
com.ukids.client.phone	xiaoxiaoyouqu
tv.tvguo.androidphone	dianshiguo
com.hisense.ms.fly2tv	haixinjuhaokan
com.video.v8090	huoquxiaoshipin
com.video.kd	kuaidouduanshipin
com.zstv	zhongshanshoujitai
com.tencent.abcmouse	tengxunabcmouse
com.m4399.youpai	4399youpai
com.android.wasu.enjoytv	huashudianshi
com.waqu.android.general_video	waqu
com.ninexiu.sixninexiu	jiuxiuzhibo
cn.myhug.baobao	baobaozhibo
com.youku.crazytogether	laifengzhibo
com.mobimtech.natives.ivp	aimizhibo
com.wandoujia.eyepetizer	kaiyan
com.cctv4g.cctvmobiletv	shoujicctv
com.v1.video	diyishipin
com.ztgame.dudu	duduquanminzhibo
com.lehai.ui	lehaizhibo
com.renren.mobile.android	renrenzhibo
taole.com.quokka	suiyuzhibo
com.tiange.hz.happy88	huanlezhibo
com.sohu.qianfan	qianfanzhibo
com.gameabc.zhanqiAndroid	zhanqizhibo
com.huomaotv.mobile	huomaozhibo
cmccwm.mobilemusic	miguyinyue
com.tencent.qqmusic	qqyinyue
cn.kuwo.player	kuwo.music
com.djbox.product	djyinlehe
fm.xiami.main	xiamiyinyue
com.kugou.android	kugouyinyue
bubei.tingshu	lanrentingshu
com.changba	changba
com.netease.cloudmusic	163yunyinyue
fm.qingting.qtradio	qingtingfm
com.ximalaya.ting.android	ximalayating
com.yibasan.lizhifm	lizhifm
cn.banshenggua.aichang	aichang
com.ifeng.fhdt	fenghuangfm
com.tencent.karaoke	quanminkge
org.ajmd	ajimidefm
com.kunpeng.babyting	baobeitingting
com.imusic.iting	aiting4g
com.shoujiduoduo.dj	djduoduo
com.evideo.MobileKTV	kmi
com.yiyou.ga	ttyuyin
cn.kuwo.tingshu	kuwotingshufm
com.ss.readpoem	weinisongdu
com.duoduo.duoduocartoon	duoduodonghuawu
com.youban.xblerge	xiaobanlongerge
com.tan8	danqinba
com.yusi.chongchong	chongchonggangqin
com.meet.pianolearn	gangqinjiaolian
com.theonepiano.pianist	zhinenggangqinke
com.duoduo.opera	xiquduoduo
com.shinyv.cnr	zhongguoguangbo
com.shoujiduoduo.duoshow	duolaidian
com.muyuan.android.ringtone	66lingsheng
com.ximalaya.ting.kid	ximalayaertong
cn.missevan	maoerfm
com.tencent.radio	qiefm-tingxiaoshuoxiangshengqingganyinle
com.kuaiyin.player	kuaiyin
com.cootek.national.ringtone	quanminlingsheng
com.zq.live	sige
com.iflytek.womusicclient	woyinyue
com.wandoujia.phoenix2	wandoujia
com.qihoo.appstore	360shoujizhushou
cn.goapk.market	anzhishichang
com.yingyonghui.market	yingyonghui
com.sogou.androidtool	sougoushoujizhushou
com.lion.market	chongchongzhushou
com.gh.gamecenter	guanghuanzhushou
com.aspire.mm	mmyingyongshangchang
com.tencent.tmgp.WePop	paopaokadingche
com.tencent.tmgp.cf	chuanyuehuoxian
com.tencent.tmgp.speedmobile	qq.feiche
com.pwrd.wlwz.aligames	wulinwaizhuan
com.tencent.pao	tiantiankupao
com.tencent.game.rhythmmaster	jiezoudashi
com.tencent.tmgp.supercell.clashofclans	buluochongtu
com.happyelements.AndroidAnimal.qq	kaixinxiaoxiaole
com.supercell.boombeach.uc	haidaoqibing
com.tencent.tmgp.qjnn	qijinuannuan
cn.jj	JJdoudezhu
com.huluxia.gametools	huluxia
com.bairimeng.dmmdzz.huawei	taopaobashaonian
com.netease.dhxy.uc	dahuaxiyou
com.tencent.JWX	aoshixiyou
com.gamebox.shiba	18youxihe
com.cw.gamebox	1haowanjia
com.sportq.fit	fit
com.yoosee	youkantou2
com.xtc.watch	xiaotiancai
com.qqgame.hlddz	huanledoudizhu
com.ztgame.bob	battleofballs
com.aiwu.market	aiwuyouxibaohe
com.blizzard.wtcg.hearthstone	lushichuanshuo
com.tencent.tmgp.sgame	wangzherongyao
com.netease.x19	wodeshijie
com.wepie.snake.tencent	tanchishedazuozhan
com.tencent.KiHan	huoyingrenzhe
com.join.android.app.mgsim.wufun	wufanyouxiting
com.ledou.mhhy.wdj	menghuanhuayuan
com.tencent.tmgp.pubgmhd	hepingjingying
com.tencent.tmgp.supercell.clashroyale	huangshizhanzheng
com.taptap	taptap
com.tencent.peng	tiantianaixiaochu
com.kiloo.subwaysurf	ditiepaoku
com.tencent.qt.qtl	zhangshangyingxionglianmeng
com.outfit7.mytalkingtomfree	wodetangmumao
com.tencent.qt.sns	zhangshangchuanyuehuoxian
com.kwai.sogame	kuaishouxiaoyouxi
com.tencent.tmgp.minitech.miniworld	wodeshijieminitech
com.kamitu.drawsth.standalone.free.android	fengkuangcaichengyu
com.tencent.gamehelper	tengxunyouxizhushou
com.tencent.tmgp.pvz2tx	zhiwudazhanjiangshi2
com.netease.tom.huawei	maohelaoshu
com.tencent.tmgp.NBA	zuiqiangnba
com.mewe.wolf	fanjulangrensha
com.tencent.game.SSGame	tiantianfeiche
com.tencent.tmgp.coslegend	yinghunzhiren
cn.flytalk.shudu	shudu
com.tencent.qqgame.xq	tiantianxiangqi
com.happyelements.AndroidClover.www	haibinxiaoxiaole
com.tencent.tmgp.bh3	benghuai3
com.tencent.shootgame	hundouluoguilai
com.qileyx.ddz.yyb	huanxidoudizhu
com.tencent.tmgp.qqx5	qqxuanwushouyou
com.tencent.qqlivekid	xiaoqieleyuan
com.ubestkid.beilehu.android	beilehuerge
com.tencent.fifamobile	fifazuqiushijie
com.lptiyu.tanke	budaolepao
com.ztgame.fir.uc	zhengtu2
com.sofunny.Sausage	xiangchangpaidui
com.tencent.cldts	guangrongshiming
com.lequ.main	lequ
com.sencent.mm	mingrenpengyouquan
com.pdragon.new2048	xin2048
com.imbastar.c5game	c5game
com.wedobest.xiangqi	xiangqi4
com.ycgame.smsy.aligames	shumenshouyou
com.tencent.tmgp.xinhuluwa	huluwazhengban
com.tencent.tmgp.dwrg	diwurenge.shengcunleiduliyouxi
com.wedobest.piano	baikuaierdaren3
com.lzj.shanyi	shanyi
com.k7k7.goujihd.yybhd.v2	duolegouji4
com.kingnet.gundam.aligames	gandazhengfengduijue
com.tencent.tmgp.zmxyol	zaomengxiyouol4
com.netease.mrzh.huawei	mingrizhihou
com.tencent.tmgp.catcondo	maomigongyu
com.songwo.pig	yangguangyangzhuchang
com.wepie.weplay	huiwanshuishiwodi
com.outfit7.mytalkingangelafree	wodeanjila
com.tencent.tmgp.pandadastudio.ninja3	renzhebixusi3
com.netease.xy3d	menghuanxiyousanweiban
com.hypergryph.arknights	mingrifangzhou
com.team108.xiaodupi	xiaodupi
com.njh.biubiu	biubiujiasuqi
com.tencent.tmgp.ttwq	tengxunweiqi
com.tencent.LEGOCUBE	legaowuxian
com.tencent.gamehelper.smoba	wangzheyingdi
com.c2vl.kgamebox	koudailangrensha
com.hetiu.gamecenter	jinzhuyouxihezi
com.tencent.af	wangpaizhanshi
love.match.set	aishangxiaoxiaoxiao
com.caniculab.musical	danchangdaren
com.sabac.hy	huanyou
com.xmeng.mrddz	mingridoudizhu
cn.net.dascom.xrbridge	xinruiqiaopai
com.tencent.kapu	qiapu
com.yuanlue.chongwu	hudongzhuomianchongwu
com.tencent.ttcaige	caigexingqiu
tv.dasheng.vs	dashengdianjing
com.tencent.tmgp.yongyong.lztg	liangzitegong
com.tencent.lzhx	longzuhuanxiang
com.martian.qplay	qwanxiaoyouxi
com.qmyl.qifei	quanminyanglong
com.tencent.tmgp.shoufutefannaoo	shoufutefannao
com.leshu.snake	tanchishezaixianhongbaoban
com.sdbean.werewolf	tiantianlangren
cn.gloud.client.mobile	gelaiyunyouxikehuduan
com.mfp.jelly.yingyongbao	binguoxiaoxiaoxiaoxiaoxiaonengkaidian
com.tencent.swy	shiwuyu
com.tencent.tmgp.yongyong.clx	yimengjianghu
color.by.number.diamond.sequins.art.picture.cn	zuanshitutule
com.anzogame.wzry	wangzherongyaozhangyoubao
jp.co.ponos.battlecatstw	maomidazhanzheng
com.tencent.tmgp.yongyong.frxy	feirenxueyuan
com.zbsw.yizhan.go	yizhan
com.dalongtech.netbar	zhangshangwangka
com.ttsk.coinpig	jinbiyangzhuchang
cn.bigfun	bigfun
com.byfen.market	baifenwangyouxihezi
com.netease.hearthstone	lushihezi
com.lonlife.gameaccelerater	linglongjiasuqi
com.imendon.lovelycolor	shaonvyumao
com.indeed.golinks	yikeweiqi
com.q1.LWSY.android.aligames	longwu
com.leshu.gamebox	douyouxiaoyouxi
com.smwl.x7market	xiao7shouyou
com.longtugame.rxjh.aligames	rexuejianghu
com.qqgame.happymj	huanlemajiang
com.anzogame.lol	lolzhangyoubao
cmb.pb	cmbchina
com.chinamworld.main	ccb
com.chinamworld.bocmbci	chinabank
com.icbc	icbc
com.android.bankabc	nongyebank
com.ecitic.bank.mobile	zhongxinbank
com.bankcomm.Bankcomm	bankcomm
com.yitong.mbank.psbc	youchuyinhang
cn.com.spdb.mobilebank.per	spdb
com.cgbchina.xpt	guangfayinhang
com.cebbank.mobile.cemb	cebbank
cn.com.cmbc.newmbank	minshengyinhang
cn.com.bhbc.mobilebank.per	bohaishoujiyinxing
com.chinatelecom.bestpayclient	yizhifu
com.lakala.android	lakala
com.paic.zhifu.wallet.activity	yiqianbao
com.unionpay	yunshanfu
com.cib.cibmb	xingyeyinhang
com.hxb.mobile.client	huaxiashoujiyinhang
com.yitong.fjnx.mbank.android	fujiannongcunxinyongsheshoujiyinxingkehuduan
com.gbanker.gbankerandroid	huangjinqianbao
com.yitong.mbank.jjccb	jiujiangyinxing
com.yitong.ksrcb.mbank.android	kunshannongshangxing
com.shengjingbank.mobile.cust	shengjingyinxing
com.csii.hkb	hankouyinxing
com.cmcc.hebao	hebaozhifu
com.netease.epay	wangyizhifu
com.rytong.bankbj	beijingyinxing
cn.jsb.china	jiangsuyinhang
com.haixia	haixiayinxing
com.itcode.reader	manmanmanhua
com.erdo.android.FJDXCartoon	aidongman
com.qq.ac.android	tengxundongman
com.android.comicsisland.activity	manhuadao
com.kuaikan.comic	kuaikanmanhua
com.diyidan	diyidan
com.wbxm.icartoon	kanmanhua
com.weibo.comic	weibodongman
com.comic.isaman	aisamanhua
com.naver.linewebtoon.cn	dongman2
com.tencent.nijigen	bodong
com.bilibili.comic	bilibilimanhua
com.liansong.comic	xiaojimanhua
com.iqiyi.comic	aiqiyimanhua
com.comic.comicapp	haokanmanhua
com.u17.comic.phone	youyaoqimanhua
cn.cj.pe	139.mail
com.sina.mail.free	sina.mail
com.tencent.androidqqmail	qq.mail
com.asiainfo.android	woyouxiang
com.corp21cn.mail189	189.mail
com.netease.mail	wangyiyouxiangdashi
com.xunlei.downloadprovider	thunder
com.pplive.androidphone	pptv
com.funshion.video.mobile	fengxing
com.kdweibo.client	yunzhijia
com.sg.sledog	sougouhaomatong
com.baidu.searchbox	baidu.other
com.dianping.v1	dazhongdianping
com.foundao.xinhua_android	xinhuawang
com.m4399.gamecenter	4399youxihe
com.wuba	58tongcheng
com.sina.news	sinaxinwen
com.anjuke.android.app	anjuke
com.ifeng.news2	fenghuangxinwen
com.sohu.newsclient	sohuxinwen
com.tencent.news	qqxinwen
com.netease.newsreader.activity	163xinwen
com.house365.newhouse	365taofang
com.babytree.apps.pregnancy	babytree
com.wondertek.paper	pengpaixinwen
com.nineteenlou.nineteenlou	19lou
com.zol.android	zhongguancunzaixian
com.chinahr.android.m	zhonghuayingcaiwang
com.zhaopin.social	zhilianzhaopin
bczp.activity	baichengqiuzhibao
com.sogou.activity.src	sougousousuo
com.mogujie	mogujie
com.cubic.autohome	autohome
cn.damai	damaiwang
com.zhihu.android	zhihu
com.lovebizhi.wallpaper	aibizhi
vz.com	feichangzhun
com.douguo.recipe	douguomeishi
com.infzm.ireader	nanfangzhoumo
com.shoujiduoduo.ringtone	lingshengduoduo
com.ss.android.article.news	jinritoutiao
com.hupu.games	hupu
com.xiachufang	xiachufang
com.szzc	shenzhouzuche
com.yongche.android	yidaoyongche
android.zhibo8	zhiboba
com.umetrip.android.msky.app	hanglvzongheng
com.lingan.seeyou	meiyou
com.tuan800.tao800	zhe800
com.yumc.phsuperapp	bishengke
fm.jihua.kecheng	kechenggezi
com.kingsoft	jinshanciba
cn.chinabus.main	8684gongjiao
com.baidu.wenku	baiduwenku
com.docin.zlibrary.ui.android	doudingshufang
cn.ninegame.gamemanager	jiuyou
com.quanleimu.activity	baixingwang
com.guokr.android	guokejingxuan
com.huanqiu.news	huanqiushibao
com.jesson.meishi	meishijie
com.netease.huatian	huatian
cn.cntvnews	cctvxinwen
com.theotino.chinadaily	chinadaily
com.womai	zhongliangwomaiwang
me.chunyu.ChunyuDoctor	chunyuyisheng
com.manle.phone.android.yaodian	zhangshangyaodian
com.baidu.iknow	baiduzhidao
com.baidu.baike	baidubaike
com.iflytek.ringdiyclient	kuyinlingsheng
com.wangzhi.MaMaHelp	lamabang
com.meitu.meipaimv	meipai
com.kugou.android.ringtone	kugoulingsheng
com.caijing	caijingzazhi
com.jingdian.tianxiameishi.android	meishitianxia
cn.ecook	wangshangchufang
cn.mucang.xiaomi.android.wz	quanguoweizhangchaxun
com.agoda.mobile.consumer	agoda
com.vmall.client	huaweishangcheng
com.liulishuo.engzo	yingyuliulishuo
com.soft.blued	blued
com.duitang.main	duitang
com.yaya.mmbang	mamabang
com.jiongji.andriod.card	baicizhan
com.jiuxianapk.ui	jiuxianwang
com.lofter.android	lofter
com.mtime	mtime
com.koudai.weidian.buyer	weidian
com.xiaomi.shop	xiaomishangcheng
com.csair.mbp	nanfanghangkong
com.rytong.hnair	hainanhangkong
com.air.sz	shenzhenhangkong
com.bw30.zsch	sichuanhangkong
com.china3s.android	chunqiuhangkong
com.towords	tuoci
com.duolingo	duolinguo
com.baidu.homework	zuoyebang
com.xtuone.android.syllabus	chaojikechengbiao
com.fenbi.android.gaozhong	yuantiku
com.wenba.bangbang	xuebajun
com.greenline.guahao	weiyi
com.sankuai.meituan.takeoutnew	meituanwaimai
com.husor.beibei	beibeiwang
com.UCMobile	UCliulanqi
com.tencent.mtt	qq.browser
com.smzdm.client.android	shenmezhidemai
com.jianshu.haruki	jianshu
cc.fotoplace.app	zuji
com.anzogame.game	dnfzhangyoubao
com.anzogame.hs	lushichuanshuozhangyoubao
com.dongqiudi.news	dongqiudi
com.android36kr.app	36ke
com.hipu.yidian	yidianzixun
com.peopledailychina.activity	renminribao
com.ruanmei.ithome	itzhijia
com.boxfish.stu	boxfishheziyuyingyu
com.nineton.weatherforecast	zhongyangtianqiyubao
com.edu.android.daliketang	qingbeiwangxiao
com.gj_1bbmm.primaryenglish	xiaoxueyingyurenjiaoban
com.qingclass.jgdc	jiguangdanci
com.color.by.number.paint.ly.pixel.art.cn	paintly
com.tuoluo.world	tuoluoshijie
com.xiachufang.lazycook	lanfanmeishi
com.shenmo.yunxuetangapp	shenmoxuetang
cn.lnts.fc	lunengtiyu
com.power.dapengeducation	dapengjiaoyu
qingclass.qukeduo.app	qukeduo
com.net.zdsoft.netstudy.netstudy_v5_mobile_app	kehouwang
com.huitouche.android.app	shengshenghuitouche
com.hunting.matrix_callershow	hailaidian
com.justjump.loop	loop
com.yoloho.dayima	dayimayuejingqizhushou
com.example.gxcs_app	guangxirenshe12333
com.truedian.dragon	weishangxiangce2
com.imibaby.client	mitu2
com.ichoice.wemay	weimai2
com.netease.gl	wangyidashen
com.sup.android.superb	pipixia
com.fenbi.android.leo	xiaoyuankousuan
com.google.android.apps.translate	googlefanyi
com.banma	banmahuiyuan
cn.ji_cloud.android	jiyunpuhuiyundiannao
com.imaginer.yunji	yunji2
com.yiche.autoeasy	yiche
com.sitech.ac	anhuimobile
com.glodon.drawingexplorer	cadkuaisukantu
cn.guancha.app	guanchazhe
com.wandafilm.app	wandadianying
com.julanling.app	anxinjijiaban
com.haodf.android	haodaifu
com.alibaba.wireless	alibaba
com.sinovatech.unicom.ui	liantongyingyeting
com.dailyyoga.cn	meiriyujia
com.enjoymeet.aloapp	aloha
com.wodi.who	wanba
com.yipiao	zhixinghuochepiao
com.autohome.mycar	weizhangchaxunzhushou
com.pingan.papd	pinganhaoyisheng
com.dashang.tiangou	tiangouwang
com.wifi.key	wifiyaoshi
com.hpbr.bosszhipin	bosszhipin
com.lchr.diaoyu	diaoyuren
com.qyer.android.jinnang	qiongyou
com.yaochufa.app	yaochufazhoubianyou
com.mampod.ergedd	ergediandian
com.yiban.app	yiban
com.gexing.ui	gexing
com.eolexam.com.examassistant	gaokaobang
com.dotamax.app	max
com.rong360.app	rong360
com.wm.dmall	duodian
com.oecommunity.oeshop	1haoshequ
com.meishe.videoshow	meishe
com.jym.mall	jiaoyimao
com.gamersky	youminxingkong
com.flamingo.gpgame	guopanyouxi
com.zl.fqbao	zhaolianjinrong
cn.emoney.pf	yimengcaopanshoujiaqiangban
com.cmschina.stock	zhiyuanyihutong
com.eastmoney.android.berlin	dongfangcaifu
com.fengjr.mobile	fenghuangjinrong
com.guagua.finance	guaguacaijing
com.bokecc.dance	tangdouguangchangwu
com.zxscnew	zhongxinzhengquan
com.lphtsccft	zhanglecaifutong
com.lejent.zuoyeshenqi.afanti	afanti
com.ibike.publicbicycle.activity	yonganxing
com.android.app.quanmama	quanmamayouhuiquan
com.bstoneinfo.pics	tupiansousou
com.basestonedata.instalment	xiaoxiangyoupin
com.dealmoon.android	beimeishengqiankuaibao
me.suncloud.marrymemo	hunliji
com.yuantiku.tutor	yuanfudao
tc.everphoto	everphoto
com.quvideo.xiaoying	xiaoying
com.seblong.idream	woniushuimian
com.job.android	qianchengwuyou51job
com.secoo	sikushechipin
com.yek.android.game5173	5173youxijiaoyi
com.smk	hangzhoushiminka
com.hhxx.juniorlanguage	chuzhongyuwen
com.qihoo.loan	360jietiao
com.iflytek.elpmobile.smartlearning	zhixuewang
com.greenpoint.android.mc10086.activity	zhongguoyidong
com.example.businesshall	zhejiangyidongyingyeting
com.xiaomi.smarthome	mijia
com.wuba.zhuanzhuan	zhuanzhuan
com.jzzs.ParentsHelper	anquanjiaoyupingtai
com.showself.ui	xiusemeinvxiuchang
com.hjwordgames	hujiangkaixincichang
cn.mama.pregnant	mamawangyunyu
com.ataaw.tianyi	tianyishenghuo
com.sogou.toptennews	jinrishidaredian
com.ks.kaishustory	kaishujianggushi
com.bmcc.ms.ui	beijingyidongshoujiyingyeting
com.songheng.eastnews	dongfangtoutiao
cn.weli.story	weilikankan
com.maihan.tredian	taozuiredian
com.lianjia.beike	beikezhaofang
com.hbmcc.heshenghuo	hebeiyidongheshenghuo
com.seewo.easicare.pro	banjiyouhuadashi
com.maimemo.android.momo	momobeidanci
com.cmcc.gs	helongyuan
com.wisedu.cpdaily	jinrixiaoyuan
com.xuanke.kaochong	kaochong
cn.edu.zjicm.wordsnet_d	zhimibeidanci
com.newcapec.mobile.ncp	wanmeixiaoyuan
com.able.wisdomtree	zhidao
com.suma.gztong	guizhoutong
com.appshare.android.ilisten	koudaigushi
com.koalareading.koalareading	kaolayuedu
com.qb.qtranslator	tengxunfanyijun
com.gem.tastyfood	shixingshengxian
com.jifen.qukan	qutoutiao
com.lucky.luckyclient	luckincoffee
com.psyone.brainmusic	xiaoshuimian
com.zhengnengliang.precepts	zhengqichijiejiesezhushou
com.haoyisheng.mobile.app	haoyisheng
com.kq.kq36.com	kangqiangyiliaorencaiwang
com.xiangkan.android	xiangkan
com.yuncheapp.android.pearl	kuaikandian
com.tencent.reading	kandiankuaibao
cn.gzmovement	dongjingxinwen
com.hcj.gznews	huachengjia
jyeoo.app.ystudy	jingyouwang
com.ttxmzq.pandamakemoney.asjz	aishangjianzhi
c.l.a	shandianhezi
com.planet.light2345	wanzhuanxingqiu
io.dcloud.H514D19D6	dailiantong
com.cdvcloud.maanshan	jinrimaanshan
com.founder.chenzhourb	jinrichenzhou
cn.cty.hbzw	ehuiban
cn.com.gxrb.client	guangxiyun
com.yy.huanju	hello
com.founder.maanshan	mashangapp
net.evecom.android.mztapp	minzhengtong
com.taimukeji.taimu	taimugu
com.yek.android.kfc.activitys	kendejikfc
qzyd.speed.nethelper	baminshenghuo
com.hnr.dxxw	daxiangxinwen
com.fcbox.hiveconsumer	fengchao
com.hlkj.gnsmrz	ningguilaijinlingwangzheng
com.qiku.android.calendar	wuyouwannianli
com.chance.zhangshangpingyao	zhangshangpingyao
com.sangame.jjhcps.android	jintouwang
cn.j.hers	tashequ
com.threegene.yeemiao	xiaodoumiao
com.zbj.zhouse	zhihuxing
com.jzkd001.medicine	zhiyeyishizhenti
com.chinamcloud.wangjie.a3283eba9fbb2be252ff95aa8df491a9e	diyangxinwen
mobi.wonders.android.apps.smy	shiminyun
com.kingdon.mycz	wodechangzhou
cn.com.gxrb.ngjb	nanguojinbao
com.dzwww.sd.android	haibaoxinwen
com.midea.ai.appliances	meidemeiju
com.haobo.huilife	yunnanyidongheshenghuo
com.droidpiggy.weiqi	weiqibaodian
com.linkedin.android	linkedinlingying
com.pingan.smt	ishenzhen
com.qisi.youth	youth
com.youzikuaibao.tianji	youzikuaibao
com.rytong.airchina	zhongguoguohang
com.lanjinger.choiassociatedpress	cailianshe
com.wondertek.cj_yun	changjiangyun
com.duoyi.implayer	duoyizhanmeng
com.cnsltx.miban	jiujiuyuyin
net.kdnet.club	kaidishequ
com.taihai.app2	kanxiamen
com.xcar.activity	aiqiaqiche
com.idol.android	aidou
com.truckhome.bbs	qiachezhijia
com.doumi.jianzhi	doumi
net.unitepower.zhitong	zhitongrencaiwang
com.qihoo.browser	360liulanqi
cn.com.pcauto.android.browser	taipingyangqiche
com.sinovatech.gxmobile.ui	guangxiyidonghezhanggui
com.hexin.plat.android	tonghuashun
com.android.dazhihui	dazhihui
com.gtfund.app	guotaijijin
lthj.exchangestock	xincaitong
cn.com.sina.finance	xinlangcaijing
com.jd.jrapp	jingdongjinrong
com.rrh.jdb	jiedaibao
com.cmbchina.ccd.pluto.cmbActivity	zhangshangshenghuo
com.lufax.android	lujinsuo
com.zhangdan.app	51xinyongkaguanjia
com.ppdai.loan	paipaidaijiekuan
com.hundsun.winner.pazq	pinganzhengquan
com.xiaomi.jr	xiaomijinrong
com.gf.client	guangfazhengquanyitaojin
com.yanxin.eloanan	feidai
com.xiaoying.cardloan	xiaoyingkadai
com.jfbank.wanka	jiufuwanka
com.guotai.dazhihui	guotaijunanjunhong
com.foundersc.app.xf	xiaofangkehuduan
zhongxinjiantou.szkingdom.android.newphone	zhongxinjiantouzhengquan
com.daofeng.zuhaowan	zuhaowan
com.tencent.portfolio	tengxunzixuangu
com.pa.health	pinganjiankang
cn.com.csbank	eqianzhuang
com.shark.jizhang	shayujizhang
com.wukonglicai.app	wukonglicai
com.creditwealth.client	yirencaifu
com.csii.tianjin.mobilebank	tianjinyinxing
com.gzyct.yctwallet	yangchengtong
dongzheng.szkingdom.android.phone	zhangzhengbaolicaijiaoyiruanjian
com.yongloveru.hjw	meitianzhuandian
com.viewstap.zhuandian	zhuandian
com.qixin.mihuas	mihuashi
com.aisino.xdj	hangxinbangbang
com.thinkive.android.invest_ha	huaanhuiying
com.hqgq.android	huanqiugangqinwang
com.eastmoney.android.choice	choiceshuju
com.chinarainbow.tft	tianfutong
com.xueqiu.android	xueqiugupiao
com.pengda.mobile.hhjz	daodaojizhang
cn.gov.tax.its	gerensuodeshui
com.icbc.im	gongyinrongelian
com.hexin.plat.android.ZhongyuanSecurity	zhongyuanzhengquancaishengbao
com.hexin.plat.android.ShenWanSecurity	shenwanhongyuandayingjia
com.bill99.kuaiqian	kuaiqianshua
com.citiccard.mobilebank	zhongxinyinxingdongqiakongjian
com.youcash.ZYWallet	zhongyouqianbao
com.android.haitong	haitongehaitongcai
com.dzqh.online11	dongfangzhengquanqihuo
com.pmp.ppmoney	ppmoneychujie
qianlong.qlmobile	qianlongshoujibanzhengquanfenxiruanjian
com.galaxy.stock	zhongguoyinhezhengquan
com.sfpay.mobile	shunfengjinrong
com.baidu.wallet	duxiaomanjinrong
com.antfortune.wealth	mayicaifu
cn.opda.a.phonoalbumshoushou	baidushoujiweishi
com.auntec.zhuoshixiong	zhuoshixiong
cn.lezhi.speedtest	wangsuguanjia
com.qihoo.cloudisk	360anquanyunpan
com.taobao.taobao	taobao
com.jingdong.app.mall	jingdong
com.thestore.main	yihaodian
com.dangdang.buy2	dangdang
com.jm.android.jumei	jumeiyoupin
com.suning.mobile.ebuy	suning
com.culiukeji.huanletao	chuchujie
com.achievo.vipshop	vipshop
com.starbucks.cn	xingbake
com.husor.beidian	beidian
com.xiaoshijie.sqb	haosheng
com.yaya.zone	dingdongmaicai
com.jf.lkrj	huashengriji
com.shizhuang.duapp	du
com.meicai.mall	meicaishangcheng
cn.missfresh.application	meiriyouxian
com.xunmeng.pinduoduo	pinduoduo
me.ele	eleme
com.taobao.idlefish	xianyu
com.alfl.www	aishangjie
com.glamour.android	meilihui
com.pupumall.customer	pupu
com.msyc.onion	yangcongomall
com.yishouapp.fumi	yishounvzhuangfuzhuangpifa
com.jinying.mobile	zhangshangjinying
com.hanfuhui	hanfuhui
com.yunding.noopsychebrush	oukelin
com.huanshou.taojj	taojiji
com.mengtuiapp.mall	mengtui
com.hsb.colaproduct	keleyoupinshangcheng
com.mujirenben.liangchenbufu	hongrenzhuang
com.n_add.android	fenxiangshenghuo
com.ocj.oms.mobile	dongfanggouwu
com.alimama.moon	taobaolianmeng
com.hhsq	huhushengqian
com.app.bfb	aikebao
com.ymt360.app.mass	yimutian
com.mia.miababy	miyabaobei
com.yougou	yougoushishangshangcheng
com.meilishuo.higo	higo
com.pipipifa.pilaipiwang	pipiwangfuzhuangnvzhuangpifa
com.black.unique	qishitequan
com.netease.yanxuan	wangyiyanxuan
com.zdwh.wwdz	wanwudezhi
com.taobao.etao	yitao
com.netease.buff	wangyibuffyouxishipinjiaoyipingtai
cn.igxe	igxe
com.xiaomi.youpin	xiaomiyoupin
com.cctir.huinongbao	huinongwang
com.fanli.android.apps	fanli
com.nike.plusgps	nikerunning
com.zhenpin.luxurystore	zhenpinwang
com.vancl.activity	fanke
com.leixun.haitao	haihuhaitao
com.dji.store	djistore
ctrip.android.view	xiechenglvxing
com.Qunar	qunar
com.dp.android.elong	yilong
com.tuniu.app.ui	tuniulvyou
com.booking	bookingquanqiujiudianyuding
com.qingdaonews.bus	qingdaogongjiaochaxun
com.wsecar.wsjcsj	wanshunchezhu
com.futurefleet.pandabus.ui.yx	taoduchuxing
com.ttyongche.ttpinecone	songguochuxing
com.futurefleet.dongguantongbus.ui.dg	dongguantong
com.lxt.app	kailicheng
com.topgether.sixfoot	liuzhijiaohuwaixianlu
com.bwton.msx.fzb	fuzhouditiemashangxing
com.mfw.roadbook	mafengwolvyou
com.tongcheng.android	tongchenglvyou
com.cictec.wisdombus.dongying	dongyingzhihuigongjiao
com.cictec.busintelligentonline	yigongjiao
com.baojia.mebike	xiaomidanche
com.gvsoft.gofun	gofunchuxing
com.xisue.zhoumo	zhoumoqunaer
com.plateno.botaoota	jinjiangjiudian
com.reocar.reocar	karuizuche
com.xiaozhu.xzdz	xiaozhu
com.ehai	yihaizuche
com.rytong.ceair	dongfanghangkong
com.htinns	huazhu
com.futurefleet.pandabus.ui	xiongmaochuxing
com.qq.qcloud	weiyun
com.baidu.netdisk	baiduwangpan
com.chinamobile.mcloud	hecaiyunwangpan
com.moji.mjweather	mojitianqi
cn.dictcn.android.digitize.swg_xhzd_21003	xinhuazidian
com.youdao.dict	youdaocidian
com.baidu.baidutranslate	baidufanyi
sina.mobile.tianqitong	tianqitong
com.icoolme.android.weather	zuimeitianqi
com.tencent.qqpinyin	qqshurufa
com.intsig.camscanner	saomiaoquannengwang
com.mt.mtxx.mtxx	meituxiuxiu
vStudio.Android.Camera360	xiangji360
com.yinxiang	yinxiangbiji
com.youdao.note	youdaoyunbiji
com.mymoney	suishouji
com.when.coco	365rili
cn.etouch.ecalendar	zhonghuawannianli
com.gtgj.view	gaotieguanjia
com.flightmanager.view	hangbanguanjia
com.mygolbs.mybus	wuxianchengshizhangshanggongjiao
com.antutu.ABenchMark	antutupingce
cn.ledongli.ldl	ledongli
com.codoon.gps	gudongyundong
com.snda.wifilocating	wifiwannengyaoshi
com.zuzuChe	zuzuche
com.Autoyol.auto	aotuzuche
com.calendar.UI	huanglitianqi
co.runner.app	yuepaoquan
com.dewmobile.kuaiya	kuaiya
com.cmcm.sports	yundongzhuan
com.quqi.quqioffice	quqiyunpan
com.jx.space	touxiangdaquan
com.msw0573.hpk	wunianjixiaceyingyu
chuxin.shimo.shimowendang	shimowendang
com.taobao.movie.android	taopiaopiao
cn.emagsoftware.gamehall	migukuaiyou
com.wordscon.axe	juzikong
cn.canva.editor	canva
com.ss.android.lark	feishu
com.sj4399.gamehelper.hpjy	4399hepingjingyingzhushou
com.shanling.mwzs	mowanzhushou
com.teambition.teambition	teambition
com.A17zuoye.mobile.homework	yiqixiaoxuexuesheng
com.lu.ashionweatherbanner	tianqi8
com.iqiyi.paopao	aiqiyipaopao
com.qujianpan.client	qujianpan
com.tencent.gallerymanager	xiangceguanjia.r1
com.zebra.ichess	guoxianglianmeng
mobi.htjsq.accelerator	haitunshouyoujiasuqi
com.meta.xyx	233xiaoyouxi
com.i8dudata.wechatrecover	huifuliaotianjilu
com.angding.smartnote	yiji
com.vpgame.eric	vpdianjing
com.androidesk	anzhuobizhihandongtaibizhi
com.ainemo.dragoon	xiaoyuyilian
com.tencent.docs	tengxunwendang
com.nice.main	nice2
com.h4399.gamebox	4399zaixianwan
com.yuedong.sport	yuedongquan
com.zhangyangjing.starfish	haixingmoniqi
cn.com.langeasy.LangEasyLexis	bubeidanci
com.ziipin.homeinn	shoulvrujia
com.jike.shoujimama	shoujimama
com.crgt.ilife	zhangshanggaotie
com.jd.app.reader	jingdongdushu
com.denglin.moji	moji
com.nfyg.hsbb	huashengditie
com.gorgeous.lite	qingyanxiangji
com.cmcm.gamemaster	youxichaoren
com.bly.dkplat	duokaifenshen
cn.wsds.gamemaster	xunyoushouyoujiasuqi
com.jy.recorder	lupingjingling
com.coolapk.market	kuan
com.cameras.prettygirls	zhuangbanshaonv
com.kdanmobile.android.pdfreader.google.pad	pdf.reader
com.xunruifairy.wallpaper	bizhijingling
com.yuewen.authorapp	zuojiazhushou
com.ktls.fileinfo	cunchukongjianqingli
com.medibang.android.paint.tablet	medibangpaint
com.iflytek.oshall.ahzwfw	wanshitong
com.zhy.qianyan	qianyan
com.qeeyou.app.accelerator	qiyoushouyoujiasuqi
com.sand.airdroid	airdroid
com.octinn.birthdayplus	shengriguanjia
com.taobao.qianniu	qianniu
cn.poco.jane	jianpin
com.xiaobanlong.main	xiaobanlong
com.picsart.studio	picsart
com.leixun.taofen8	taofenba
sogou.mobile.explorer	android.sougouliulanqi
com.browser2345	2345liulanqi
com.gotokeep.keep	keep
com.chebada	bashiguanjia
com.yulore.yellowpage	dianhuabang
pinkdiary.xiaoxiaotu.com	fenfenriji
com.zhihu.daily.android	zhihuribao
com.cankaoxiaoxi.app1	cankaoxiaoxi
com.caissa.teamtouristic	kaisalvyou
com.Kingdee.Express	kuaidi100
com.ci123.pregnancywap	mamashequ
com.didapinche.booking	didapinche
com.dada.mobile.shop.android	dada1
com.whty.wicity.china	heshenghuo
com.dw.btime	qinbaobao
com.dajie.official	dajie
com.fenqile.fenqile	fenqile
cn.edaijia.android.client	edaijia
com.puscene.client	meiweibuyongdeng
com.meijialove.activity	meijiabang
com.theotino.sztv	wuxiansuzhou
cn.TuHu.android	tuhuyangche
com.xiangha	xianghacaipu
com.ziroom.ziroomcustomer	ziru
dandelion.com.oray.dandelion	pugongying
com.alpha.lagouapk	lagou
com.szzc.ucar.pilot	shenzhouzhuanche
com.handsgo.jiakao.android	jiakaobaodian
cn.com.open.mooc	mukewang
com.genshuixue.student	genshuixue
com.ishowedu.peiyin	yingyuqupeiyin
com.youdao.translator	youdaofanyiguan
com.kekeclient_	kekeyingyu
com.kk.dict	kuaikuaichahanyuzidian
com.shanbay.sentence	shanbeidanci
com.duoduo.child.story	ergeduoduo
com.tal.kaoyan	kaoyanbang
cn.dict.android.pro	haicicidian
com.hujiang.hjclass	hujiangwangxiao
com.jxedt	jiaxiaoyidiantong
cn.ticktick.task	didaqingdan
com.fenbi.android.solar	xiaoyuansouti
com.happyteam.dubbingshow	peiyinxiu
com.yixia.videoeditor	miaopai
com.by.butter.camera	huangyouxiangji
com.tencent.zebra	shuiyinxiangji
com.meitu.meiyancamera	meiyanxiangji
com.meitu.poster	haibaogongchang
cn.nubia.neoshare	shijie
com.xingin.xhs	xiaohongshuhaiwaigouwushenqi
com.ttxg.fruitday	tiantianguoyuan
com.ymatou.shop	yangmatou
com.kaola	kaolahaigou
com.eusoft.eudic	oulucidian
com.screeclibinvoke	lupingdashi
com.qding.community	qianding
com.imohoo.shanpao	migushanpao
com.taobao.trip	feizhu
com.kingpoint.gmcchh	guangdongyidongshoujiyingyeting
com.tencent.wifimanager	wifiguanjia
cn.hundun.datarecovery	shoujishujuhuifujingling
com.pingan.lifeinsurance	pinganjinguanjia
com.hhdd.kada	kadagushi
com.dalongtech.cloud	yundiannao
com.ihaozhuo.youjiankang	youjiankang
com.jiandan.mobilelesson	jiandanketang
com.ishowedu.child.peiyin	shaoerqupeiyin
com.jinxin.namibox	namihe
com.jiliguala.niuwa	jiliguala
com.jx.cmcc.ict.ibelieve	hewoxin
com.mallestudio.gugu.app	chuman
doctorjob.com.cn	zhongguoyiliaorencaiwang
com.xueersi.parentsmeeting	xueersiwangxiao
com.yingsoft.ksbao.Activity	kaoshibaodian
com.yizhe_temai	yizhetemai
com.kk.dict.cidian	hanyucidian
com.yiwang	1yaowang
org.gushiwen.gushiwen	gushiwenwang
com.izaodao.gps	wushiyintu
com.hyww.wisdomtree	zhihuishu
cn.kdqbxs.reader	kuaiduquanbenxiaoshuo
az.studio.gkztc	gaokaozhitongche
com.gonlan.iplaymtg	lvfashiyingdi
com.hupu.shihuo	shihuo
com.juanpi.ui	juanpizhekou
com.flyme.meizu.store	meizushangcheng
com.xdf.recite	leci
com.yangcong345.android.phone	yangcongshuxue
so.ofo.labofo	gongxiangdanche
com.boqii.petlifehouse	boqichongwu
com.taguxdesign.yixi	yixi
com.ekwing.students	yikexuesheng
com.yuedan	yuedan
com.beautifywe.imgwish	bizhidaquan
com.biyao.fu	biyao
com.suirui.zhumu	zhumu
com.hzhu.m	haohaozhu
com.ganji.android.haoche_c	guaziershouche
com.dingYZ.dingyzwater	weishangshuiyinxiangji
com.qicai.translate	chuguofanyiguan
com.drcuiyutao.babyhealth	cuiyutaoyuxueyuan
com.hithway.wecut	Wecut
com.ants360.yicamera	xiaoyishexiangji
com.lianaibiji.dev	lianaiji
com.tujia.hotel	tujia
com.sfht.m	fengquhaitao
com.pingan.carowner	pinganhaochezhu
com.zcbl.bjjj_driving	beijingjiaojing
com.campmobile.snowcamera	b612kaji
com.xwtec.sd.mobileclient	shandongyidong
cn.youth.news	zhongqingkandian
com.coohua.xinwenzhuan	taoxinwen
com.cqmc.client	chongqingyidongshoujiyingyeting
com.mistong.ewt360	shengxueewangtong
com.shoujiduoduo.wallpaper	bizhiduoduo
com.sunrise.scmbhc	sichuanyidongzhangshangyingyeting
com.tianqi2345	2345tianqiyubao
com.vlocker.locker	weisuoping
com.talk51.kid	51talkqingshaoeryingyu
com.wukongtv.wkremote.client	wukongyaokongqi
com.tianyancha.skyeye	tianyancha
com.soufun.app	fangtianxia
com.luojilab.player	dedao
com.benqu.wuta	wutaxiangji
com.tencent.ttpic	tiantianptu
com.mobike.mobikeapp	mobike
com.bankcomm.maidanba	maidanba
com.taobao.mobile.dipei	koubei
com.cainiao.wireless	cainiaoguoguo
com.ifreetalk.ftalk	paipai1
com.tencent.tgclub	xinyuejulebu
com.baidu.mbaby	baidubaobaozhidao
com.jingyao.easybike	haloudanche
com.netease.uu	wangyiuujiasuqi
com.meitu.makeup	meizhuangxiangji
com.lanjingren.ivwen	meipian
com.jzyd.coupon	shengqiankuaibao
com.sinyee.babybus.recommendapp	baobaobashi
com.tmri.app.main	jiaoguan12123
com.ct.client	dianxinyingyeting
com.suning.mobile.epa	suningjinrong
com.xinhang.mobileclient	henanyidongyingyeting
com.gamestar.perfectpiano	wanmeigangqin
com.app.shanghai.metro	metrodaduhui
com.sdu.didi.psnger	didichuxing
com.welove520.qqsweet	qinglvkongjian
com.comic.manhuatai	manhuatai
com.max.xiaoheihe	xiaoheihe
cn.buding.martin	weicheweizhangchaxun
com.iflytek.vflynote	xunfeiyuji
com.seebaby	zhangtongjiayuan
com.iflytek.cmcc	migulingxi
com.tencent.djcity	zhangshangdaojucheng
cn.caocaokeji.user	caocaozhuanche
smskb.com	shengmingshikebiao
com.kuaiduizuoye.scan	kuaiduizuoye
org.xinkb.blackboard.android	xiaoheiban
com.pingan.xueyuan	zhiniao
ai.zuoye.app	aizuoye
com.tsingzone.questionbank	yiqikaojiaoshi
com.bertadata.qxb	qixinbao
com.shiqichuban.android	shiqi
com.infinitus.bupm	wuxianjizhongguo
com.tiqiaa.icontrol	yaokongjingling
cn.danatech.xingseapp	xingse
com.sing.client	5singyuanchuangyinyue
com.cn21.ecloud	tianyiyunpan
com.baojiazhijia.qichebaojia	maichebaodian
com.jingdong.pdj	jingdongdaojia
com.wudaokou.hippo	hema
com.tencent.tmgp.wooduan.ssjj	shengsijuji
com.winupon.weike.android	weikezhangshangtong
com.pcncn.jj	zuoyejingling
com.meetstudio.app.Zither	guzheng
com.boohee.one	bohejiankang
com.mandian.android.dongdong	dongdongjibuqi
com.gift.android	lvmamalvyou
com.nowcasting.activity	caiyuntianqi
com.chaoxing.mobile	xuexitong
com.mm.android.lc	lecheng
com.sunland.app	shangdejigou
com.plan.kot32.tomatotime	fanqietodo
com.shangfang.gylm	gaoyonglianmeng
com.ss.android.tuchong	tuchong
com.ichinait.gbpassenger	shouqiyueche
enfc.metro	yitongxing
com.banshenghuo.mobile	banshenghuo
com.oray.sunlogin	xiangrikuiyuanchengkongzhi
com.nursinghome.monitor	kanhujia
com.keji.lelink2	lianxiangkanjiabao
com.kwai.videoeditor	kuaiying
com.hbxwatchpro.cn	taoqibeibei
cn.paperang.mm	miaomiaoji
com.shenmeiguan.psmaster	ptudashen
com.gdcn.sport	quntitong
com.systoon.beijingtoon	beijingtong
com.wondersgroup.hs.healthcloud.patient	jiankangyun
com.zaijia.xiaodu	xiaoduzaijia
com.cj.yun.esz	yunshangenshi
com.mike.textocr	wenzishibie
com.dreamtd.kjshenqi	jimengmaomizhuomianchongwu
cn.nineton.starget	xiaomubiao
nutstore.android	jianguoyun
com.yjs.android	yingjieshengqiuzhi
com.mst.activity	baoantong
com.cloudbae.lovenanning	ainanning
com.xmcy.hykb	haoyoukuabao
com.z.hhwk	zuoyehuzhuzu
com.coomix.app.car	qichezaixian
com.kwai.livepartner	kuaishouzhibobanlv
com.duwo.reading	banyuhuiben
com.sgcc.wsgw.cn	zhangshangdianli
com.cmri.universalapp	hejiaqin
com.microsoft.bing	weiruanbiying
com.fxicrazy.sjml	lianzhangmenhu
cn.com.robusoft.floweridentification	huabanlv
com.ichano.athome.avs	zhangshangkanjiacaijiduan
com.techwolf.kanzhun.app	kanzhun
com.zivn.cloudbrush3	shufazidiandaquan
com.digitalchina.mobile.dfhfz1	efuzhou
com.biku.diary	qingningshouzhang
com.danale.video	danale
com.iplay.assistant	ggdawanjia
com.tsy.tsy	taoshouyou
com.bilibili.a3	a3mankaijutuanceshifu
com.broaddeep.safe.parents	yangguangshouhujiazhangban
com.tencent.qqpim	qqtongbuzhushou
com.jiayouya.travel	lvxingshijie
com.yitantech.gaigai	bixinpeilian
com.qsmy.walkmonkey	buduoduo
com.huodao.hdphone	zhaoliangji
com.lemon.lv	jianying1
com.tencent.wemeet.app	tengxunhuiyi
com.blueberry.lxwparent	lanxiaomi
com.broaddeep.discipline	yangguangzilv
com.xiaomi.xiaoailite	xiaoaitongxue
cn.zepeto.main	zaizaizepeto
com.ailide.apartmentsabc	ailixiong
com.rockets.chang	changya
com.xiaoxun.xun	xiaoxun
com.huawei.health	huaweiyundongjiankang
com.spero.vision.vsnapp	gupai
com.flash.matrix_wallpaper	shandongbizhi
com.hoge.android.app.newsban	zhihuiheyuan
com.filemagic	chaoqiangqinglidashi
com.camerasideas.instashot	inshotshipinjianji
com.pedometer.money.cn	huanlezou
com.tiantianaituse	manyatang
jp.ne.ibis.ibispaintx.app	ibispaintx
com.ludashi.benchmark	ludashianzhuoban
com.energysh.onlinecamera1	dashenptu
com.hp.printercontrol	huipuyidongdayin
com.oray.sunlogin.service	xiangrikuikehuduan
com.jz.youyu	youyujizhang
video.vue.android	vuevlog
com.mengzhu.app	mengzhu2
com.pdmi.guangzhou.media	xinhuacheng
com.xiaodu.smartspeaker	xiaoduyinxiang
com.fundubbing.dub_android	tiantianpeiyin
com.jwzt.tongling	tonglingshoujitai
com.xgimi.zhushou	wupingzhushou
com.fdcxxzx.xfw	xuanfangwang
com.poooli.printer	boli
net.qihoo.launcher.widget.clockweather	360tianqi
io.moreless.tide	chaoxi
com.youloft.calendar	51wannianli
cn.com.htjc.pay	dianebao
com.liziyuedong.goldpig	jinzhushengdaqian
com.mop.catsports	maopuyundong
com.kugou.shiqutouch	fufuleida
com.excean.gspace	googlekongjian
com.game.matrix_pixelpaint	kaixintutule
com.feiteng.lieyou	lieyou
com.maiya.weather	jiandantianqi
com.besto.beautifultv	guangxishiting
com.freshpower.android.college	ediangongyunketang
com.languo.memory_butler	jiyiguanjia
com.inpor.fastmeetingcloud	haoshitongyunhuiyi
com.sl.whale	jingming
com.uxin.live	kelakela
com.mobile.kadian	qiadianshipinzhizuo
com.mendon.riza	rizaxiangji
com.tudao.RobotMake	robotmakejiqirenkongzhiruanjian
com.jsmcc	zhangshangyingyeting
com.zdworks.android.zdclock	zhengdiannaozhong
com.auramarker.zine	zine
com.qihoo.gameunion	360shouyoudating
com.theone.ailianqin	theoneailianqin
cn.dxy.idxyer	dingxiangyuan
com.muyuanapp.android.dororo	kuaishouxiaojuchang
com.zheyun.qhy	quhuyan
com.gnet.onemeeting	quanshiyunhuiyi
android.lite.clean	tengxunqinglidashi-shoujiweishiguanjia
com.tencent.cmocmna	tengxunshouyoujiasuqi
com.eastmoney.android.fund	tiantianjijin
com.czb.fleet	tuanyouzhuanyeban
com.baidu.youavideo	yikexiangce
com.quyin.mprinter	yinxiansen
com.ls.jjs.myaps	zhuankezhuanlianxueshengduan
com.suncamctrl.live	yaokongdashi
com.youxiang.soyoungapp	xinyangyimei
cn.visionkeep.product	chaojishilibiao
com.jd.campus	liwo
com.xingluo.gncolor	tusexiaohuajia
com.taobao.homeai	tangping
com.hanweb.android.zhejiang.activity	zheliban
com.love.walk.qsport	aizoulu
com.tian.voicechangerpro	bianshengqimianfeiban
com.jingling.chongdian	chongdianyouqian
gz.lifesense.weidong	lexinjiankang
e.room.Escape	mianguan
com.moxiu.mxwallpaper	moxiubizhi
com.mubu.app	mubu
com.hudun.videoedit	qingshuangshipinbianji
com.sh.cm.shydhn	shanghaiyidongheni
com.doushi.cliped	douceshipinbianji
com.pmatrix.iconchange	huantubiao
com.actionsmicro.ezcast	ezcast
com.duowan.bi	biushenqi
com.tencent.xriver	tengxunjiasuqi
com.xiaomi.mimobile	xiaomiyidong
com.tataera.daquanhomework	zuoyedaandaquan
com.ingka.ikea.app.cn.prod	ikeayijiajiaju
com.hxak.liangongbao	liangongbao
com.yunke.android	yunke
com.joke.bamenshenqi.help	bamenzhushou
com.picooc	picooc
com.nexstreaming.app.kinemasterfree	qiaoying
com.zzw.october	zhiyuanhui
com.ido.dongha_ls	heilouyundong
com.duorong.smarttool	shiguangxu
com.zego.talkline	talkline
com.wangniu.sharearn	qianbaobaozhuanqianshenqi
com.mike.changtu	changtupinjie
top.onepix.timeblock	kuaishijian
com.hanweb.android.sdzwfw.activity	aishandong
com.zm.sport	butiantian
com.eco.global.app	ecovacshome
com.hanson.e7langapp	yiqilang
com.inspur.icity.tianjin	jinxinban
com.hnjc.dl	duorui
com.laidian.xiu	laidianxiuxiu
com.eusoft.eshelper	xiyuzhushou
com.jkhh.nurse	hushijia
com.ddmh.livewallpaperandroid	huancaizhuomian
com.jdd.motorfans	haluomotuo
com.feioou.print	delixiangyinbao
com.dwb.renrendaipai	renrendaipai
com.jd.jdhealth	jingdongjiankang
com.todo.vvrentalnumber	vvzuhao
com.xuanzhuanzimu.android	yizimu
com.lietou.mishu	liepin
cn.kidyn.qdmedical160	jiankang160yuyueguahaozixunpingtai
com.xiwei.logistics	yunmanmansiji
com.xiaofish.lovesport	duoduoaiyundong
com.snowcorp.sodacn.android	shuiyouxiangji
com.qihui.elfinbook	elfinbook
com.loganproperty.owner	longguanghui
com.shineyue.sjgjj	shoujigongjijin
com.focusgene.findme	zhenwo
com.woaika.kashen	woaiqia
com.wanmeizhensuo.zhensuo	gengmei
com.greentree.android	gelinhaotai
com.doc360.client	gerentushuguan
com.haier.uhome.uplus	haierzhijia
com.my21dianyuan.electronicworkshop	dianziyanxishe
com.chinalife.ebz	zhongguorenshoushouxian
com.cmcc.numberportable	heduohao
com.homelink.android	lianjia
com.hf	zhongguotianqi
com.elipbe.dict	guoyuzhushou
com.laba.wcs	weichaishi
com.movitech.grandehb	hengfangtong
photo.editor.polarr	polaxiutu
com.xvideostudio.videoeditor	lexiushipinjianjishipinbianji
com.jm.fxw	faxingwu
com.huawei.fans	huafenjulebu
com.hlg.daydaytobusiness	gaodingsheji
com.android.abustory	abushuiqiangushi
com.tinmanarts.jojosherlock	jiaojiaoshizibaobaorenzizaojiaoban
com.barbaloong.frozenprincesscoloringshow	gongzhutusexiu
com.hongen.app.word	hongenshizi
com.qihoo360.antilostwatch	360ertongweishi
com.yw.kidsongs	ergeqianqian
com.yixinjiang.goodbaba.app.presentation.pep	haobabarenjiaowaiyansheban
com.koolearn.english.donutabc	duonaxueyingyu
com.vipkid.app	vipkidyingyu
com.xxt.jxlxandroid	henanxiaoxuntong
com.ihuman.book	hongenshuangyuhuiben
com.mytian.appstore.wk	maitianxieziwang
com.ihuman.imath	hongenshuxue
com.xiaohaizi.ui	xiaohaizidiandu
com.benew.ntt	niutingting
com.ihuman.story	hongengushi
com.bruce.english	baobaoxueyingyu
com.xqw369.ttsz	tiantianshizi
cn.xckj.talk_junior	banyushaoeryingyu
com.unis.mollyfantasy	molihuanxiang
com.ln.lqsz	ertongjiaoyuleqishizi
com.xfanread.xfanread	fandengxiaoduzhe
com.bruce.learning	kantushizi
com.ubestkid.beilehutown.a	beilehuxiaozhen
com.yunshuxie.main	jingdiandaodu
com.bruce.baby	baobaoaishizi
com.md.fhl	gushicifeihualing
com.pxjy.app.student	puxinshisheng
com.aixuetang.online	aixuetang
com.lexue100	lexueyibai
com.vipabc.vipmobilejr	vipjrhd
com.joinfonet.atx	aitingxie
com.lks	likeshuo
com.wawj.app.t	woaiwojia
com.work.onlineschool	zhuolu
com.tongyi.edu	tongyijiaoyu
com.hzty.magiccube	kuailexuetangxueshengduan
com.xinghuolive.live	xiaojiaoyu
com.hengtiansoft.tgedu.checkanswer	zuoyedashi
com.dinoenglish.yyb	eyingyubao
com.yunxiao.haofenshu	haofenshu
com.duia.duiaapp	duiaketang
com.kk.poem	gushicidian
com.tbkt.student	tongbuketangxuesheng
com.huiian.timing	timing
com.dasheng.b2s	wuyouketang
cn.babyfs.android	baobaowanyingyu
com.up366.mobile	tianxuewang
com.sogou.translator	sougoufanyi
com.qmtt.qmtt	qimengtingtingergegushi
com.haojiazhang.activity	xiaoxuebao
com.razkidscamb.americanread.android.architecture.newrazapp	razketang
com.css.bj.css	aikecheng
cn.tc.umu	umuhudong
com.xnw.qun	xiaoneiwai
com.mumars.student	weiboshixueshengduan
com.yyxx.study	yuyinxitong
com.lizi.yuwen	yuwen100fen
com.zhuoyue.z92waiyu	92waiyu
com.physicmaster	wulidashiyichuzhongban
com.mxr.dreambook	4dshucheng
com.mistong.opencourse	kaikela
com.xdf.ucan	youboke
com.orange.note	chengguocuotiben
com.lanjiyin.xiyikaoyan	yixuekaoyanlanjiyin
com.nwoolf.xy.b500	beishidaxiaoxueshuxuequanji
com.jtcloud.teacher	jingbanyun
com.gankaowangxiao.gkwx	gankaozhuangyuan
com.yxjy.chinesestudy	yuwentongbuxue
com.qpx.pinying	tuxiaobeipinyin
com.fengbee.zhongkao	zhongkaofengbei
com.openlanguage.kaiyan	kaiyanyingyu
com.lft.turn	daoxuehao
com.baicizhan.ireading	baicizhanaiyuedu
com.lizhiweike	lizhiweike
com.yl.edu	youlujiaoyu
com.nwoolf.xy.hbmdd	haobamadiandu
zwzt.fangqiu.edu.com.zwzt	zuowenzhitiao
com.hujiang.cctalk	cctalk
com.ketchapp.fingerdriver	finger
com.baicizhan.dict	baicizhancidian
com.youdao.reciteword	youdaobeidanci
com.meishubao.client	meishubao
com.handsgo.jiakao.android.kehuo	jiaolianbaodian
com.zmlearn.course.am	zhangmen1dui1fudao
com.bakclass.web	beikewang
com.bruce.idiom	chengyucaicaicai
net.huanci.hsj	huashijie
com.cwwangzk.junirenlish	chuzhongyingyubao
com.moqu.lnkfun	moqushufa
com.huayi.cme	zhangshanghuayi
com.vanthink.student	zaixianzhujiaoxuesheng
com.immusician.music	aiyinlexueyuan
com.gaotu100.superclass	gaotuketang
org.wanmen.wanmenuni	wanmendaxue
com.zhumaonline.exercise	zhumafakao
com.laixue.lxagent	laixuebaodian
com.sainti.eduread	chukouchengzhang
com.tencent.k12	qiefudao
com.caiyuninterpreter.activity	caiyunxiaoyi
com.alo7.android.student	aileqi
com.talcloud.raz	xuediyuedu
com.yondor.student	yuandaxiaozhuangyuan
com.fenbi.android.zenglish	banmayingyu
com.gumi.spokenenglish	renjiaokouyu
com.dedao.juvenile	shaoniandedao
air.com.A9kylins.dezico	zhudikeshizi
com.edusoa.cdwl	chidiaowuli
com.joinfonet.alz	ailianzi
org.zywx.wbpalmstar.widgetone.uex11109379	handian
com.spark.peak	dianfengxunlian
com.tal.abctimelibrary	abctime
com.rj.syslearning	tongbuxue
com.scho.manager	zhangshangxueyuan
com.btsj.hpx	baitongyixue
com.joyshow.joyshowcampus	lexianyunketang
com.meijiale.macyandlarry	youjiaoxinshi
com.sprite.foreigners	shaguayingyu
com.onesoft.app.Tiiku.Duia.KJZC	chujihuijizhichengsuishenxue
com.iyuba.TEDVideo	tedyingyuyanjiang
com.wutongtech.climbingreading	pandengyuedu
com.zhaowen.caocao	caocaojiangzuowen
com.hfjy.LearningCenter	haifengzhixuezhongxin
com.duia.app.Putonghua	putonghuaxuexiceshi
com.apicloud.A6983463631733	xuezizhaiketang
com.akax.haofangfa	haofangfaketang
cn.xuexi.android	xuexiqiangguo
com.knowbox.rc.student	xiaohexuesheng
com.wisemen.hhb	huihuabao
com.tencent.edu	tengxunketang
com.shensz.student	yiqizuoyezhongxuexueshengduan
com.yiqizuoye.jzt	yiqixue
cn.eeo.classin	classin
cn.xdf.roombox.app	xindongfagyunjiaoshi
com.xes.jazhanghui.activity	xueersipeiyou
com.zhl.fep.aphone	minjiaoxuexi
com.bjhl.weishi	weishixuexi
com.kooup.student	xindongfangzaixianzhongxiaoxue
cc.septnet.scholar	xiaoqixueban
com.tongxue.tiku	xueersiqingke
com.youdao.course	youdaojingpinke
com.leleketang.SchoolFantasy	tiantianlian
com.yqxue.yqxue	yiqixuewangxiao
com.pep.diandu	renjiaodiandu
com.netease.edu.ucmooc	zhongguodaxuemooc
com.zybang.parent	zuoyebangkousuan
com.knowbox.rc.student.pk	xiaohejiazhang
com.mosoink.teach	yunbanke
com.deskmate100	tongzhuo100
com.ivydad.readtool	changqingtengbabazaojiao
air.com.gongfubb.wksz	wukongshizi
com.youdao.kiddict	youdaoshaoercidian
cn.com.gridinfo	12xuexuesheng
cn.com.igdj.shopping	yunxiaotong
com.strong.letalk	letao
com.wumii.android.athena	yidianyingyu
com.android.weici.senior.student	weici
com.aijiao100.study	baifenketang
com.zy.course	guorouwangxiao
com.android.jj.superparent	jinjiangixue
com.focustech.android.mt.parent	jiaodianjiaxiao
com.online.xthk	xintianhuakaizaixian
com.qinlin.ahaschool	ahaschool
com.dongao.kaoqian.phone	huijiyunketang
com.zjy.ykt	yunketangzhihuizhijiao
com.zhan.ieltstiku	xiaozhanyasi
com.qicaibear	qicaixionghuiben
com.pnlyy.pnlclass.pnlclass_student	vippeilian
com.nd.app.factory.sdev	wangjiaotong
cn.ait.tsk.student	ailaoshixueshengduan
com.hht.bbparent	aixuebanbanjiachangduan
com.unnoo.quan	zhishixingqiu
com.liulishuo.sprout	liulishuoshaoeryingyu
DDT.QQ78551393	diandutong
com.cdel.medmobile	yixuejiaoyuwang
com.bishen.zuowen	bishenzuowen
com.xunsheng.app.school	xunshenglangduxiaoyuanban
com.kid58.tiyong.characters	miaoxuehanzi
com.yunti.zzm	shulian
com.wu7zhi.www	zhifoudaxue
com.me.fzw.dashanonline	xuexi8
com.motk	motiku
com.theonepiano.smartpiano	yiyizhinenggangqin
software.ecenter.study	zhuangyuangongxiangketang
com.infotop.aiedu	xuecexing
tv.buka.android	buqiahudong
com.seewo.picbook.pro	daweixiongyingyu
com.mop.gproverb	datiduobao
com.win100edu.a100	a100jiaoxue
com.pandaabc.stu	aikeshaoeryingyuxueshengduan
cn.boyakids.m	boyaxiaoxuetang
com.ecnup.aXG3Io	bangnixue
com.i61.dengta	hualalaxiaodengta
com.wiseman.writing	genwoxuexiehanzi
com.okay.jx	fangxiang
com.kanlixiang.android	kanlixiang
com.easysay.korean	hanyuuxueyuan
com.saker.app.huhu	huhushouyinji
com.ihuman.english	hongenertongyingyu
com.kpl.student	kuaipeilian
com.huanxiongenglish.flip	huanxiongxuetang
com.rayclear.renrenjiang	renrenjiang
com.hexfuture.hexfamily	jiatingduan
com.aixuexi.gushi	aixuexigushi
com.annie.annieforchild	annihua
science.bigkexue.com	dakexue
com.dd.dingdonglive	dingdongketang
com.gfs.android.highscoretalk	gaofenshuoxinban
com.i61.draw.live	hualalavipketang
com.huatu.handheld_huatu	huatuzaixian
com.textbookmaster.publisher.cn	kebentongxiaoxueyuwenxuexipingtai
com.aspirecn.xiaoxuntongParent.ln	liaoninghejiaoyu
edu.www.qsxt	qingshuxuetang
uni.UNI0EA15B0	shuchengketang
com.hexinedu.sigma.assistant	waiyanaixuexiban
com.xiyou.english	xiyouyingyu
com.zero.xbzx.student	xuebazaixian
com.xuexiaoyi.xxy	xuexiaoyi
com.zgxt.app	zhugexuetang
com.up360.parents.android.activity	xiangshangwang
com.sflep.course	welearnsuixingketang
com.zmyouke.course	zhangmenyouke
com.wanhe.eng100.listening	tinglibaifenbai
com.ablesky.ui.activity	nenglitiankong
com.pxwx.student	puxinwangxiao
com.codemao.nemo	bianchengmaonemo
com.jifen.game.words	chengyudafuhao
com.cheesestar.octonauts.tencent	haidixiaozongduixueyingyu
com.hexiaoxiang.yuwen	hexiaoxiangdayuwen
com.mobcoreapp	hexiaoxiangxiezipingtai
cn.xdf.lespeaking	letingshuo
com.liulishuo.vira	liulishuo-yuedu
cn.mfxsqbyd.reader	mianfeixiaoshuoquanbenyuedu
com.tydic.hf.edu	mingshiyunketang
com.qingclass.pandora	panduolayingyu
com.ai3culture.poem	shiwendian
com.doutu.tutuenglish	tutuertongyingyu
cn.lianqinba.strings	yiqilianqin
com.gj_1bbmm.ylenglish	yilinxiaoxueyingyu
com.wyt.iexuetang.hd.zxxtb	zhongxiaoxuefudaoban
com.acadsoc.talkshow	aqiasuoyingyu
com.jzjy.ykt	yanketang
com.slanissue.apps.mobile.erge	beiwaergeertongzaojiao
com.eletell.wow	weilaizhiguang
com.forhy.jingruistudent	ijingruixueshengban
com.blingabc.student	bilinwaijiao
com.mytian.appstore.ma	maitianshuxue
com.mytian.appstore.en	maitianyingyu
com.youthmba.ymbaandroid	shaonianshangxueyuananzhuoban
com.wenba.xbjtutor	xuebajun1dui1shouji
com.wyzwedu.www.baoxuexiapp	baoxuexi
com.kongming.android.h.parent	daliaifudao-xiaoxueshuxueyuwenzuoyepigaizhushou
cc.talentyer.edu	gailunguojijiaoyu
cn.huohua.edustudent	huohuasiweizaixianhudongzhibopingtai
com.example.yuanren123.learnjanpanese	jinchuanriyuxuexiwushiyintu
com.ken.ninebeats	jiupaipeinilian
cc.septnet.student	qitianxuetang
com.dengguo.editor	dengguoxiezuo
com.syhd.scbs	shouchaobaozuoye
com.ctsig.oneheartb	xueshengshouji
com.zhl.jlyy.aphone	jielixuexi
com.aifudao	haofenshufudaoandroidban
com.mowan365.lego	mowanchuangke
com.oczhkj.declaim	songdubang
com.abc360.student	abc360yingyu
com.sflep.iting	aitingwaiyu
com.miaokids.math	youxuemaoshuxue
com.plw.student	peilianwaxuesheng
com.kaochong.kaochong_word	kaochongdanci
com.xueersi.monkeyabc.app	xiaohouyingyu
cn.idashi.app	dashi100
com.kuaike.app	jiangxixiaoxuntong
com.xueguoxue.xgxw2018	xueguoxuewang
com.tal.abctime	libuqimeng
com.chivox.student.kami	chishengtingshuozaixian
UCUX.APP	youkeyouxin
com.zxkj.spokenstar	kouyuxingqiu
com.huahua.testing	putonghuaceshi
com.xiaoyezi.student	xiaoyezipeilian
com.gkid.gkid	gkidyingyu
cn.bcbook.app.student	wuhaoxuesheng
com.ellabook	yilakanshuhuibengushi
com.aiitec.letar	gongxiangshizi
com.xuehaiyouxue.android.videoEdu	xuehaiyouxue
cn.taozhi.kousuan	taozhikousuan
com.unipus	waiyansuishenxue
com.eblocks.platform	elexuetang
com.ss.android.ex.parent	gogokidyingyu
cn.bookln.saas.jiuwei9	jiuweiyouxuebang
com.puxi.app	shuxuebaodian
com.seewo.en	xiwobaiban
org.cocos2d.gameidiom	chengyufengkuangcai