微信	weixin
QQ	qq
抖音短视频	douyin
百度	baidu.other
快手	gifkuaishou
王者荣耀	wangzherongyao
作业帮	zuoyebang
和平精英	hepingjingying
网易云音乐	163yunyinyue
爱奇艺	aiqiyi
QQ音乐	qqyinyue
酷狗音乐	kugouyinyue
腾讯视频	qq.video
哔哩哔哩	bilibili
手机淘宝	taobao
QQ浏览器	qq.browser
拼多多	pinduoduo
西瓜视频	xiguashipin
我的世界	wodeshijie
今日头条	jinritoutiao
喜马拉雅	ximalayating
新浪微博	sina.weibo
一起小学学生	yiqixiaoxuexuesheng
百度网盘	baiduwangpan
高德地图	amap
优酷视频	youku
网易有道词典	youdaocidian
小猿搜题	xiaoyuansouti
知乎	zhihu
百词斩	baicizhan
全民K歌	quanminkge
快对作业	kuaiduizuoye
学而思网校	xueersiwangxiao
七猫免费小说	qimaomianfeixiaoshuo
穿越火线-枪战王者	chuanyuehuoxian
快点	kuaidianyuedu
抖音火山版	huoshanxiaoshipin
酷我音乐	kuwo.music
火影忍者	huoyingrenzhe
趣头条	qutoutiao
快看漫画	kuaikanmanhua
百度地图	baiduditu
好看视频	haokanshipin
触漫	chuman
QQ飞车手游	qq.feiche
球球大作战	battleofballs
迷你世界	wodeshijieminitech
腾讯新闻	qqxinwen
京东	jingdong
美图秀秀	meituxiuxiu
多看阅读	duokanyuedu
番茄ToDo	fanqietodo
名人朋友圈	mingrenpengyouquan
学习强国	xuexiqiangguo
Timing	timing
有道翻译官	youdaofanyiguan
金山词霸	jinshanciba
小红书	xiaohongshuhaiwaigouwushenqi
百度翻译	baidufanyi
猿辅导	yuanfudao
饭局狼人	fanjulangrensha
安全教育平台	anquanjiaoyupingtai
纳米盒	namihe
刷宝	shuabao2
美拍	meipai
欢乐斗地主	huanledoudizhu
洋葱学院	yangcongshuxue
LOFTER	lofter
流利说-英语	yingyuliulishuo
半次元	banciyuan
微信读书	weixindushu
晓黑板	xiaoheiban
凯叔讲故事	kaishujianggushi
画世界	huashijie
伴鱼绘本	banyuhuiben
B612咔叽	b612kaji
画吧	huaba
轻颜相机	qingyanxiangji
纸条	zuowenzhitiao
皮皮蟹	pipixie
明日方舟	mingrifangzhou
闲鱼	xianyu
最右	zuiyou
智学网	zhixuewang
配音秀	peiyinxiu
小学宝	xiaoxuebao
小盒学生	xiaohexuesheng
虎牙直播	huyazhibo
央视影音	cntv
小企鹅乐园	xiaoqieleyuan
高途课堂	gaotuketang
摩拜单车	mobike
小恩爱	xiaoenai
联通手机营业厅	liantongyingyeting
可可英语	kekeyingyu
虾米音乐	xiamiyinyue
英语趣配音	yingyuqupeiyin
荔枝	lizhifm
升学e网通	shengxueewangtong
滴滴出行	didichuxing
起点读书	qidianzhongwen
翼课学生	yikexuesheng
芒果TV	mangguoTV
车来了	chelaile
蜻蜓FM	qingtingfm
企业微信	qiyeweixin
悟饭游戏厅	wufanyouxiting
Keep	keep
百度贴吧	baidutieba
58同城	58tongcheng
掌阅	iReader
哈啰出行	haloudanche
洪恩识字	hongenshizi
得物(毒)	du
一米阅读	yimiyuedu
饿了么	eleme
萤石云视频	yingshiyunshipin
小猿口算	xiaoyuankousuan
QQ阅读	qq.read
皮皮搞笑	pipigaoxiao
陀螺世界	tuoluoshijie
漫画台	manhuatai
掌上出行	wuxianchengshizhangshanggongjiao
墨迹天气	mojitianqi
识货	shihuo
咪咕音乐	miguyinyue
腾讯动漫	tengxundongman
天天象棋	tiantianxiangqi
少年得到	shaoniandedao
萌推	mengtui
小方客户端	xiaofangkehuduan
懒人听书FM	lanrentingshu
BeautyCam美颜相机	meiyanxiangji
Boss直聘	bosszhipin
广东移动手机营业厅	guangdongyidongshoujiyingyeting
宝宝巴士	baobaobashi
堆糖	duitang
无他相机	wutaxiangji
天天P图	tiantianptu
百词斩爱阅读	baicizhanaiyuedu
腾讯翻译君	tengxunfanyijun
儿歌多多	ergeduoduo
菠萝包轻小说	boluobaoqingxiaoshuo
口碑	koubei
不背单词	bubeidanci
小伴龙	xiaobanlong
微视	weishi
网易公开课	163gongkaike
QQ邮箱	qq.mail
中国移动	zhongguoyidong
喵喵机	miaomiaoji
铃声多多	lingshengduoduo
咪咕视频	he.video
晋江小说阅读	jinjiangwenxuecheng
汽车之家	autohome
跟谁学	genshuixue
少儿趣配音	shaoerqupeiyin
糖豆	tangdouguangchangwu
酷我畅听	kuwotingshufm
扇贝单词英语版	shanbeidanci
墨墨背单词	momobeidanci
儿歌千千	ergeqianqian
中国建设银行	ccb
叨叨记账	daodaojizhang
出口成章	chukouchengzhang
人人视频	renrenshipin
儿歌点点	ergediandian
快影	kuaiying
ABCReading	abctime
唯品会	vipshop
懂球帝	dongqiudi
斗鱼直播	douyutv
九游	jiuyou
东方头条	dongfangtoutiao
伴鱼少儿英语	banyushaoeryingyu
快剪辑	kuaijianji
沪江网校	hujiangwangxiao
波波视频	boboshipin
学习通	xuexitong
腾讯地图	qqditu
铁路12306	12306
蓝舞者	lanwuzhe
樊登小读者	fandengxiaoduzhe
嘀嗒出行	didapinche
追书神器	zhuishushenqi
美柚	meiyou
爱作业	aizuoye
极光单词	jiguangdanci
在线助教学生	zaixianzhujiaoxuesheng
飞猪	feizhu
咪咕阅读	heyuedu
转转	zhuanzhuan
JJ斗地主	JJdoudezhu
小孩子点读	xiaohaizidiandu
国象联盟	guoxianglianmeng
好爸妈点读	haobamadiandu
掌门1对1辅导	zhangmen1dui1fudao
亿通行	yitongxing
大智慧	dazhihui
网易UU加速器	wangyiuujiasuqi
携程旅行	xiechenglvxing
电信营业厅	dianxinyingyeting
物理大师	wulidashiyichuzhongban
腾讯企鹅辅导	qiefudao
华为商城	huaweishangcheng
火锅视频	yooshipin
激萌猫咪桌面宠物	jimengmaomizhuomianchongwu
云听	zhongguoguangbo
中国银行手机银行	chinabank
QQ输入法	qqshurufa
Paint.ly	paintly
搜狐视频	sohu.video
云舒写	jingdiandaodu
光环助手	guanghuanzhushou
乐学一百	lexueyibai
凤凰新闻	fenghuangxinwen
百度文库	baiduwenku
花生地铁	huashengditie
PP视频	pptv
CC直播	cczhibo
中华万年历	zhonghuawannianli
作家助手	zuojiazhushou
企鹅电竞	qiedianjing
下厨房	xiachufang
有道背单词	youdaobeidanci
优播课	youboke
同花顺	tonghuashun
欧路词典	oulucidian
海风智学中心	haifengzhixuezhongxin
豆瓣	douban
完美校园	wanmeixiaoyuan
酷狗铃声	kugoulingsheng
小米商城	xiaomishangcheng
超级课程表	chaojikechengbiao
万门大学	wanmendaxue
小蚁摄像机	xiaoyishexiangji
星巴克	xingbake
微博士家长端	weiboshixueshengduan
vipjrHD	vipjrhd
爱乐奇	aileqi
KaDa故事	kadagushi
迅游手游加速器	xunyoushouyoujiasuqi
咕咚	gudongyundong
海词词典	haicicidian
向日葵远程控制	xiangrikuiyuanchengkongzhi
韩剧TV	hanjuTV
途虎养车	tuhuyangche
VIPKID英语	vipkidyingyu
漫读小说	manduxiaoshuo
什么值得买	shenmezhidemai
网易新闻	163xinwen
考研帮	kaoyanbang
麦田写字王	maitianxieziwang
多闪	duoshan
爱壁纸	aibizhi
悦跑圈	yuepaoquan
掌通家园	zhangtongjiayuan
92外语	92waiyu
拾柒	shiqi
阿里巴巴	alibaba
CCtalk	cctalk
2345天气预报	2345tianqiyubao
360影视大全	360yingshidaquan
拓词	tuoci
中国医疗人才网	zhongguoyiliaorencaiwang
哔哩哔哩漫画	bilibilimanhua
节奏大师	jiezoudashi
掌上英雄联盟	zhangshangyingxionglianmeng
民生银行手机银行	minshengyinhang
阿凡题	afanti
百词斩词典	baicizhancidian
联掌门户	lianzhangmenhu
百通医学	baitongyixue
西窗烛	xichuangzhu
美术宝	meishubao
河南移动智慧生活	henanyidongyingyeting
爱课程	aikecheng
luckincoffee	luckincoffee
傻瓜英语	shaguayingyu
洋葱OMALL	yangcongomall
壁纸多多	bizhiduoduo
天学网	tianxuewang
掌上学院	zhangshangxueyuan
天气通	tianqitong
大拿	danale
小妖精美化	xiaoyaojingmeihua
百度阅读	baiduyuedu
交通银行	bankcomm
多邻国免费学英语	duolinguo
北京移动手机营业厅	beijingyidongshoujiyingyeting
汉典	handian
一起考教师	yiqikaojiaoshi
新东方多纳	duonaxueyingyu
康强医疗人才网	kangqiangyiliaorencaiwang
汉服荟	hanfuhui
稿定设计	gaodingsheji
微云	weiyun
京东金融	jingdongjinrong
宝贝听听	baobeitingting
探探	tantan
券妈妈优惠券	quanmamayouhuiquan
口袋故事	koudaigushi
洪恩数学	hongenshuxue
有道云笔记	youdaoyunbiji
驾考宝典	jiakaobaodian
遥控精灵	yaokongjingling
光荣使命：使命行动	guangrongshiming
虎扑	hupu
酷安	kuan
租号玩	zuhaowan
Soul	soul
乐趣	lequ
QQ空间	qzone
正气	zhengqichijiejiesezhushou
黄油相机	huangyouxiangji
神漫画	shenmanhua
东莞通	dongguantong
简单课堂	jiandanketang
南瓜电影	nanguadianying
弹琴吧	danqinba
步道乐跑	budaolepao
微鲤看看	weilikankan
天府通	tianfutong
看点快报	kandiankuaibao
新浪新闻	sinaxinwen
好未来分级阅读	xuediyuedu
苏宁易购	suning
高佣联盟	gaoyonglianmeng
新晴天气	zhongyangtianqiyubao
hope	hope
农行掌上银行	nongyebank
前程无忧51Job	qianchengwuyou51job
中考蜂背	zhongkaofengbei
网易云阅读	163yunyuedu
百度知道	baiduzhidao
天天识字	tiantianshizi
去哪儿旅行	qunar
盒马	hema
慧话宝	huihuabao
唱吧	changba
学霸君	xuebajun
联想看家宝	lianxiangkanjiabao
火萤	huoying
淘集集	taojiji
腾讯体育	tengxuntiyu
智联招聘	zhilianzhaopin
开课啦	kaikela
同步学	tongbuxue
当当	dangdang
形色	xingse
爱听写	aitingxie
搜狗阅读	sougouyuedu
和陇原	helongyuan
四川移动掌上营业厅	sichuanyidongzhangshangyingyeting
普通话学习测试	putonghuaxuexiceshi
多点	duodian
贵州通	guizhoutong
群体通	quntitong
语音学习系统	yuyinxitong
好爸爸学习机版	haobabarenjiaowaiyansheban
亲宝宝	qinbaobao
分期乐	fenqile
书法字典大全	shufazidiandaquan
时光手帐Pro	shiguangshouzhangpro
今日十大新闻	jinrishidaredian
ofo共享单车	gongxiangdanche
nice	nice2
飒漫画	aisamanhua
浙江移动手机营业厅	zhejiangyidongyingyeting
和我信	hewoxin
中青看点	zhongqingkandian
得到	dedao
交管12123	jiaoguan12123
全球购骑士特权	qishitequan
多屏互动	duopinghudong
妈妈网孕育	mamawangyunyu
叫叫识字	jiaojiaoshizibaobaorenzizaojiaoban
墨记	moji
嗨来电	hailaidian
宜兴享出行	taoduchuxing
乐动力	ledongli
驾校一点通	jiaxiaoyidiantong
安居客	anjuke
考拉阅读	kaolayuedu
宝安通	baoantong
Loop	loop
万达电影	wandadianying
红袖读书	hongxiutianxiang
医学考研	yixuekaoyanlanjiyin
彩云小译	caiyunxiaoyi
天津银行	tianjinyinxing
美篇	meipian
书耽免费耽美小说	shudandanmeixiaoshuo
网易严选	wangyiyanxuan
青岛公交查询	qingdaogongjiaochaxun
和飞信	fetion
启蒙听听儿歌故事	qimengtingtingergegushi
拉勾招聘	lagou
重庆移动	chongqingyidongshoujiyingyeting
Metro大都会	metrodaduhui
曹操出行	caocaozhuanche
青柠手帐	qingningshouzhang
移动惠生活	anhuimobile
贝乐虎小镇	beilehuxiaozhen
每日优鲜	meiriyouxian
RAZ课堂	razketang
4D书城	4dshucheng
巅峰训练	dianfengxunlian
掌上高铁	zhangshanggaotie
曹操讲作文	caocaojiangzuowen
小度在家	xiaoduzaijia
全民小视频	quanminxiaoshipin
葫芦娃	huluwazhengban
湛庐阅读	zhanluyuedu
口袋48	koudai48
搜狐新闻	sohuxinwen
同步课堂学生	tongbuketangxuesheng
羊城通	yangchengtong
无线苏州	wuxiansuzhou
看点视频	kandianshipin
钉钉	dingding
UC浏览器	UCliulanqi
奇迹暖暖	qijinuannuan
TapTap	taptap
搜狗浏览器	android.sougouliulanqi
斑马AI课	banmayingyu
360手机助手	360shoujizhushou
跑跑卡丁车	paopaokadingche
初中英语宝	chuzhongyingyubao
PicsArt	picsart
第五人格	diwurenge.shengcunleiduliyouxi
悟空遥控器	wukongyaokongqi
搜狗搜索	sougousousuo
天天飞车	tiantianfeiche
小睡眠	xiaoshuimian
滴答清单	didaqingdan
腾讯会议	tengxunhuiyi
海滨消消乐	haibinxiaoxiaole
开心消消乐	kaixinxiaoxiaole
天天爱消除	tiantianaixiaochu
贝壳找房	beikezhaofang
和地图	heditu
花椒直播	huajiaozhibo
考拉海购	kaolahaigou
小赢卡贷	xiaoyingkadai
华为运动健康	huaweiyundongjiankang
E英语宝	eyingyubao
云班课	yunbanke
同桌100	tongzhuo100
BiuBiu加速器	biubiujiasuqi
阳光养猪场	yangguangyangzhuchang
蓝小咪	lanxiaomi
喜马拉雅儿童	ximalayaertong
常青藤爸爸早教	changqingtengbabazaojiao
悟空识字	wukongshizi
优教信使	youjiaoxinshi
口袋狼人杀	koudailangrensha
YY	yywaiwai
有道少儿词典	youdaoshaoercidian
菁优网	jingyouwang
阳光自律	yangguangzilv
WiFi管家	wifiguanjia
微光	weiguang
大鹏教育	dapengjiaoyu
叽里呱啦	jiliguala
FIFA足球世界	fifazuqiushijie
皖事通	wanshitong
UMU互动	umuhudong
维词	weici
点阅小说	dianyuexiaoshuo
12xue学生	12xuexuesheng
果肉网校	guorouwangxiao
233小游戏	233xiaoyouxi
云校通	yunxiaotong
乐桃	letao
股拍	gupai
乐高无限	legaowuxian
小爱同学	xiaoaitongxue
咪咕爱看	miguaikan
一点英语	yidianyingyu
崽崽ZEPETO	zaizaizepeto
爱立熊	ailixiong
唱鸭	changya
闪动壁纸	shandongbizhi
波洞	bodong
小寻	xiaoxun
讯飞语记	xunfeiyuji
LOOK直播	lookzhibo
话本小说	huabenxiaoshuo
淘手游	taoshouyou
今日校园	jinrixiaoyuan
弹唱达人	danchangdaren
装扮少女	zhuangbanshaonv
新华字典	xinhuazidian
阅友免费小说	yueyoumianfeixiaoshuo
作业精灵	zuoyejingling
疯读小说	fengduxiaoshuo
得间免费小说	dejianmianfeixiaoshuo
万顺车主	wanshunchezhu
百分课堂	baifenketang
微博动漫	weibodongman
搜狗翻译	sougoufanyi
小学英语人教版	xiaoxueyingyurenjiaoban
会玩	huiwanshuishiwodi
AcFun	acfun
云课堂智慧职教	yunketangzhihuizhijiao
克拉有读	kelayoudu
焦点家校	jiaodianjiaxiao
一点资讯	yidianzixun
小站雅思	xiaozhanyasi
小鱼易连	xiaoyuyilian
七彩熊绘本	qicaixionghuiben
找靓机	zhaoliangji
旅行世界	lvxingshijie
MediBangPaint	medibangpaint
书旗小说	shuqixiaoshuo
VIP陪练	vippeilian
皮皮虾	pipixia
轻视频	qingshipin
网教通	wangjiaotong
爱老师学生端	ailaoshixueshengduan
藏书馆	cangshuguan
Google翻译	googlefanyi
疯狂猜成语	fengkuangcaichengyu
南方Plus	nanfangplus
爱上兼职	aishangjianzhi
爱上消消消	aishangxiaoxiaoxiao
闪电盒子	shandianhezi
A3!满开剧团	a3mankaijutuanceshifu
房天下	fangtianxia
心田花开网校	xintianhuakaizaixian
Ahaschool	ahaschool
咚漫	dongman2
欢乐走	huanlezou
网易大神	wangyidashen
小鸡漫画	xiaojimanhua
向日葵阅读	xiangrikuiyuedu
漫芽糖	manyatang
爱学班班家长端	aixuebanbanjiachangduan
知识星球	zhishixingqiu
飞卢小说	feiluxiaoshuo
流利说-少儿英语	liulishuoshaoeryingyu
步多多	buduoduo
番茄免费小说	fanqiexiaoshuo
WiFi万能钥匙	wifiwannengyaoshi
TIM	tim
影视大全	yingshidaquan2
央视频	yangshipin
班级优化大师	banjiyouhuadashi
云视讯	yunshixun
香肠派对	xiangchangpaidui
小肚皮	xiaodupi
猿题库	yuantiku
好游快爆	haoyoukuabao
动静新闻	dongjingxinwen
课后网	kehouwang
瞩目	zhumu
好分数	haofenshu
TT语音	ttyuyin
4399游戏盒	4399youxihe
阳光守护家长版	yangguangshouhujiazhangban
快看点	kuaikandian
腾讯课堂	tengxunketang
一起作业中学学生端	yiqizuoyezhongxuexueshengduan
人教点读	renjiaodiandu
zoom	zoom
一起学	yiqixue
ClassIn	classin
明日之后	mingrizhihou
新东方云教室	xindongfagyunjiaoshi
小盒家长	xiaohejiazhang
学而思培优	xueersipeiyou
作业帮口算	zuoyebangkousuan
闽教学习	minjiaoxuexi
快手小游戏	kuaishouxiaoyouxi
逃跑吧！少年	taopaobashaonian
微师	weishixuexi
MOMO陌陌	momo
新东方在线中小学	xindongfangzaixianzhongxiaoxue
扫描全能王	saomiaoquannengwang
小七学伴	xiaoqixueban
米读小说	miduxiaoshuo
浅言	qianyan
猫和老鼠	maohelaoshu
掌上看家采集端	zhangshangkanjiacaijiduan
学而思轻课	xueersiqingke
有道精品课	youdaojingpinke
天天练	tiantianlian
中国大学MOOC	zhongguodaxuemooc
一起学网校	yiqixuewangxiao
Bestv	bestv
小书亭	xiaoshuting
花城+	huachengjia
360儿童卫士	360ertongweishi
360天气	360tianqi
4399在线玩	4399zaixianwan
51万年历	51wannianli
A100教学	a100jiaoxue
爱课少儿英语学生端	aikeshaoeryingyuxueshengduan
AirDroid	airdroid
安卓壁纸-含动态壁纸	anzhuobizhihandongtaibizhi
百变大侦探	baibiandazhentan
百度百科	baidubaike
百度手机卫士	baidushoujiweishi
伴鱼自然拼读	banyuziranpindu
宝宝学英语	baobaoxueyingyu
北师大小学数学全集	beishidaxiaoxueshuxuequanji
必看免费小说	bikanmianfeixiaoshuo
笔神作文	bishenzuowen
壁纸精灵	bizhijingling
啵哩	boli
博雅小学堂	boyaxiaoxuetang
布卡互动	buqiahudong
猜歌星球	caigexingqiu
菜鸟裹裹	cainiaoguoguo
央视新闻	cctvxinwen
潮汐	chaoxi
橙光	chengguang
虫虫助手	chongchongzhushou
刺猬猫阅读	ciweimaoyuedu
代练通	dailiantong
大圣电竞	dashengdianjing
大神P图	dashenptu
答题夺宝	datiduobao
点读通	diandutong
电视果	dianshiguo
第一弹	diyidan
东方财富	dongfangcaifu
e电工云课堂	ediangongyunketang
樊登读书	fandengdushu
方象	fangxiang
飞书	feishu
高考直通车	gaokaozhitongche
跟我学写汉字	genwoxuexiehanzi
Google空间	googlekongjian
古诗词典	gushicidian
古诗文网	gushiwenwang
海信聚好看	haixinjuhaokan
好医生	haoyisheng
河南校讯通	henanxiaoxuntong
洪恩儿童英语	hongenertongyingyu
洪恩故事	hongengushi
花瓣	huaban
画啦啦小灯塔	hualalaxiaodengta
黄历天气	huanglitianqi
浣熊学堂	huanxiongxuetang
互动桌面宠物	hudongzhuomianchongwu
呼呼收音机	huhushouyinji
惠普移动打印	huipuyidongdayin
ibisPaintX	ibispaintx
简单天气	jiandantianqi
交易猫	jiaoyimao
京东到家	jingdongdaojia
今日郴州	jinrichenzhou
今日马鞍山	jinrimaanshan
金猪生大钱	jinzhushengdaqian
开心图图乐	kaixintutule
开言英语	kaiyanyingyu
看理想	kanlixiang
快陪练	kuaipeilian
快牙	kuaiya
乐视视频	letv
连信	lianxin
猎游	lieyou
荔枝微课	lizhiweike
录屏大师	lupingdashi
绿洲	lvzhou
猫耳FM	maoerfm
每天赚点	meitianzhuandian
盟主	mengzhu2
咪咕快游	migukuaiyou
明日斗地主	mingridoudizhu
魔题库	motiku
熊猫看书	panda.book
平安好医生	pinganhaoyisheng
批批网服装女装批发	pipiwangfuzhuangnvzhuangpifa
卡噗	qiapu
清北网校	qingbeiwangxiao
人教口语	renjiaokouyu
书链	shulian
teambition	teambition
天天配音	tiantianpeiyin
天眼查	tianyancha
统一教育	tongyijiaoyu
Uki	uki
VUEVlog	vuevlog
网易BUFF游戏饰品交易平台	wangyibuffyouxishipinjiaoyipingtai
网易蜗牛读书	wangyiguaniudushu
玩赚星球	wanzhuanxingqiu
小度音箱	xiaoduyinxiang
小小优趣	xiaoxiaoyouqu
新花城	xinhuacheng
新睿桥牌	xinruiqiaopai
4399和平精英助手	4399hepingjingyingzhushou
爱客宝	aikebao
陌声	mosheng
爱学堂	aixuetang
火趣小视频	huoquxiaoshipin
快逗短视频	kuaidouduanshipin
宝宝爱识字	baobaoaishizi
贝店	beidian
播播TV	bobotv
CAD快速看图	cadkuaisukantu
Canva	canva
长佩阅读	changpeiyuedu
虫虫钢琴	chongchonggangqin
全民养龙	quanminyanglong
首富特烦恼	shoufutefannao
贪吃蛇在线红包版	tanchishezaixianhongbaoban
天天狼人	tiantianlangren
Fit	fit
福建农村信用社手机银行客户端	fujiannongcunxinyongsheshoujiyinxingkehuduan
爱奇艺漫画	aiqiyimanhua
鄂汇办	ehuiban
海星模拟器	haixingmoniqi
广西云	guangxiyun
Hello	hello
马上app	mashangapp
闽政通	minzhengtong
泰木谷	taimugu
选房网	xuanfangwang
京版云	jingbanyun
中原证券财升宝	zhongyuanzhengquancaishengbao
网速管家	wangsuguanjia
考虫	kaochong
IGXE	igxe
电e宝	dianebao
肯德基	kendejikfc
好视通云会议	haoshitongyunhuiyi
酷狗直播	kugouzhibo
来学宝典	laixuebaodian
乐现云课堂	lexianyunketang
恋爱记	lianaiji
鲸鸣	jingming
记忆管家	jiyiguanjia
Memobird咕咕机	memobirdguguji
克拉克拉	kelakela
卡点视频制作	qiadianshipinzhizuo
南国早报	nanguozaobao
攀登阅读	pandengyuedu
日杂相机	rizaxiangji
途道机器人	robotmakejiqirenkongzhiruanjian
掌上营业厅	zhangshangyingyeting
正点闹钟	zhengdiannaozhong
Zine	zine
爱学习古诗	aixuexigushi
生死狙击	shengsijuji
安妮花	annihua
大科学	dakexue
搜狗手机助手	sougoushoujizhushou
泰捷视频	taijieshipin
叮咚课堂	dingdongketang
贪吃蛇大作战	tanchishedazuozhan
高分说新版	gaofenshuoxinban
TED英语演讲	tedyingyuyanjiang
腾讯NOW直播	tengxunnowzhibo
画啦啦VIP课堂	hualalavipketang
华图在线	huatuzaixian
课本通小学语文学习平台	kebentongxiaoxueyuwenxuexipingtai
蜗牛睡眠	woniushuimian
我是谜	woshimi
沃视频	woshipin2
五十音图	wushiyintu
无限极中国	wuxianjizhongguo
香哈菜谱	xianghacaipu
校内外	xiaoneiwai
辽宁和教育	liaoninghejiaoyu
青书学堂	qingshuxuetang
人人讲	renrenjiang
书成课堂	shuchengketang
易车	yiche
悦动圈	yuedongquan
云电脑	yundiannao
云集	yunji2
语文100分	yuwen100fen
掌上华医	zhangshanghuayi
外研AI学习版	waiyanaixuexiban
西柚英语	xiyouyingyu
学霸在线	xuebazaixian
学小易	xuexiaoyi
诸葛学堂	zhugexuetang
作业互助组	zuoyehuzhuzu
好省	haosheng
格来云游戏客户端	gelaiyunyouxikehuduan
平安健康	pinganjiankang
向上网	xiangshangwang
津云	jinyun
手机电视	shoujidianshi
WElearn随行课堂	welearnsuixingketang
听力百分百	tinglibaifenbai
中山手机台	zhongshanshoujitai
能力天空	nenglitiankong
为你诵读	weinisongdu
剪映	jianying1
大象新闻	daxiangxinwen
遇见漂流瓶	yujianpiaoliuping
部落冲突	buluochongtu
美团外卖	meituanwaimai
知到	zhidao
酷狗唱唱	kugouchangchang
米家	mijia
食物语	shiwuyu
皇室战争	huangshizhanzheng
微锁屏	weisuoping
植物大战僵尸2	zhiwudazhanjiangshi2
玩吧	wanba
当当云阅读	dangdangyunyuedu
锦江i学	jinjiangixue
沪江开心词场	hujiangkaixincichang
金猪游戏盒子	jinzhuyouxihezi
腾讯围棋	tengxunweiqi
会计云课堂	huijiyunketang
智慧河源	zhihuiheyuan
超强清理大师	chaoqiangqinglidashi
王牌战士	wangpaizhanshi
电视家	dianshijia
鲁大师	ludashianzhuoban
InShot视频和照片编辑软件	inshotshipinjianji
知米背单词	zhimibeidanci
最强NBA	zuiqiangnba
医学教育网	yixuejiaoyuwang
应用汇	yingyonghui
儿童教育乐奇识字	ertongjiaoyuleqishizi
豌豆荚	wandoujia
中国工商银行	icbc
腾讯开心鼠英语 ABCmouse	tengxunabcmouse
迅雷	thunder
家庭端	jiatingduan
qq炫舞手游	qqxuanwushouyou
卓鹿	zhuolu
向日葵客户端	xiangrikuikehuduan
淘宝直播	taobaozhibo
葫芦侠	huluxia
招商银行	cmbchina
宜搜小说	yisouxiaoshuo
QQ同步助手	qqtongbuzhushou
寻声朗读校园版	xunshenglangduxiaoyuanban
大众点评	dazhongdianping
猫扑运动	maopuyundong
名师云课堂	mingshiyunketang
河小象写字平台	hexiaoxiangxiezipingtai
妙学汉字	miaoxuehanzi
PDF Reader	pdf.reader
中小学辅导班	zhongxiaoxuefudaoban
智远一户通	zhiyuanyihutong
有鱼记账	youyujizhang
天翼云盘	tianyiyunpan
浮浮雷达	fufuleida
淘气贝贝	taoqibeibei
大卫熊英语	daweixiongyingyu
造梦西游OL	zaomengxiyouol4
知鸟	zhiniao
卓师兄	zhuoshixiong
一罐	yiguan
腾讯手游加速器	tengxunshouyoujiasuqi
今日影视大全	jinriyingshidaquan
翼支付	yizhifu
印象笔记	yinxiangbiji
立刻说	likeshuo
量子特攻	liangzitegong
小天才	xiaotiancai
知否大学	zhifoudaxue
猫咪公寓	maomigongyu
一梦江湖	yimengjianghu
叫叫阅读课	jiaojiaoyueduke
龙族幻想	longzuhuanxiang
学习8	xuexi8
快快查汉语字典	kuaikuaichahanyuzidian
游戏超人	youxichaoren
英魂之刃	yinghunzhiren
相册管家	xiangceguanjia.r1
智能钢琴	yiyizhinenggangqin
状元共享课堂	zhuangyuangongxiangketang
炉石传说	lushichuanshuo
掌上平遥	zhangshangpingyao
飞读免费小说	feidumianfeixiaoshuo
团油专业版	tuanyouzhuanyeban
小鬼快搜	xiaoguikuaisou
铜陵手机台	tonglingshoujitai
我的汤姆猫	wodetangmumao
韩语U学院	hanyuuxueyuan
学测星	xuecexing
Q玩小游戏	qwanxiaoyouxi
无屏助手	wupingzhushou
益盟操盘手加强版	yimengcaopanshoujiaqiangban
专课专练学生端	zhuankezhuanlianxueshengduan
乐听说	letingshuo
无忧万年历	wuyouwannianli
广西视听	guangxishiting
千牛	qianniu
初中语文	chuzhongyuwen
音派	yinpai
爱吾游戏宝盒	aiwuyouxibaohe
腾讯清理大师-手机卫士管家	tengxunqinglidashi-shoujiweishiguanjia
淘宝联盟	taobaolianmeng
潘多拉英语	panduolayingyu
WiFi钥匙	wifiyaoshi
Choice数据	choiceshuju
人民日报	renminribao
帮你学	bangnixue
崔玉涛育学园	cuiyutaoyuxueyuan
网上国网	zhangshangdianli
百度视频	baidu.video
最美天气	zuimeitianqi
爱奇艺免费阅读	aiqiyimianfeiyuedu
云闪付	yunshanfu
微课掌上通	weikezhangshangtong
洪恩双语绘本	hongenshuangyuhuiben
平安金管家	pinganjinguanjia
我的安吉拉	wodeanjila
360借条	360jietiao
河小象大语文	hexiaoxiangdayuwen
360手游大厅	360shouyoudating
数独	shudu
存储空间清理	cunchukongjianqingli
一淘	yitao
忍者必须死3	renzhebixusi3
TheONE爱练琴	theoneailianqin
智能钢琴课	zhinenggangqinke
智行火车票	zhixinghuochepiao
教练宝典	jiaolianbaodian
搜狗免费小说	sougoumianfeixiaoshuo
丁香园	dingxiangyuan
企鹅FM-听小说相声情感音乐	qiefm-tingxiaoshuoxiangshengqingganyinle
全本免费电子小说	quanbenmianfeidianzixiaoshuo
白块儿达人	baikuaierdaren3
初级会计职称随身学	chujihuijizhichengsuishenxue
图片搜搜	tupiansousou
极云普惠云电脑	jiyunpuhuiyundiannao
米阅小说	miyuexiaoshuo
趣护眼	quhuyan
Wecut	Wecut
掌门优课	zhangmenyouke
广发证券易淘金	guangfazhengquanyitaojin
编程猫Nemo	bianchengmaonemo
心悦俱乐部	xinyuejulebu
诗文典	shiwendian
CSDN	csdn
五年级下册英语	wunianjixiaceyingyu
钻石涂涂乐	zuanshitutule
一起练琴	yiqilianqin
象棋	xiangqi4
想看	xiangkan
免费小说全本阅读	mianfeixiaoshuoquanbenyuedu
朴新网校	puxinwangxiao
戏曲多多	xiquduoduo
快手小剧场	kuaishouxiaojuchang
i视视	ishishi
宝宝玩英语	baobaowanyingyu
石墨文档	shimowendang
新2048	xin2048
完美钢琴	wanmeigangqin
彩云天气	caiyuntianqi
橙果错题本	chengguocuotiben
全本免费快读小说	quanbenmianfeikuaiduxiaoshuo
印先森	yinxiansen
天天基金	tiantianjijin
流利说-阅读	liulishuo-yuedu
奇游手游加速器	qiyoushouyoujiasuqi
成语大富豪	chengyudafuhao
海底小纵队学英语	haidixiaozongduixueyingyu
录屏精灵	lupingjingling
汉语词典	hanyucidian
360安全云盘	360anquanyunpan
简拼	jianpin
图虫	tuchong
古筝	guzheng
健康云	jiankangyun
丰巢	fengchao
图图儿童英语	tutuertongyingyu
顺丰金融	shunfengjinrong
译林小学英语	yilinxiaoxueyingyu
小翼管家	xiaoyiguanjia
一刻相册	yikexiangce
全时云会议	quanshiyunhuiyi
有看头	youkantou2
懒饭美食	lanfanmeishi
光大银行	cebbank
宁归来（金陵网证）	ningguilaijinlingwangzheng
果盘游戏	guopanyouxi
八闽生活	baminshenghuo
宾果消消消	binguoxiaoxiaoxiaoxiaoxiaonengkaidian
AI音乐学院	aiyinlexueyuan
18游戏盒	18youxihe
盐课堂	yanketang
语文同步学	yuwentongbuxue
水印相机	shuiyinxiangji
魔秀壁纸	moxiubizhi
谜案馆	mianguan
趣看天下	qukantianxia
京东读书	jingdongdushu
微店	weidian
好看漫画	haokanmanhua
快手直播伴侣	kuaishouzhibobanlv
PP体育	pptiyu
麦田数学	maitianshuxue
乐心健康	lexinjiankang
她社区	tashequ
清爽视频编辑	qingshuangshipinbianji
漫画岛	manhuadao
十点读书	shidiandushu
爱家读书会	aijiadushuhui
充电有钱	chongdianyouqian
幕布	mubu
山东移动	shandongyidong
多乐够级	duolegouji4
执业医师真题	zhiyeyishizhenti
上海移动和你	shanghaiyidongheni
比邻外教	bilinwaijiao
变声器免费版	bianshengqimianfeiban
平安证券	pinganzhengquan
崩坏3	benghuai3
金投网	jintouwang
步步阅读	bubuyuedu
学霸君1对1手机	xuebajun1dui1shouji
知户型	zhihuxing
小豆苗	xiaodoumiao
包学习	baoxuexi
麦田英语	maitianyingyu
星火教育	xiaojiaoyu
酷酷跑	kukupao
少年商学院安卓版	shaonianshangxueyuananzhuoban
GG大玩家	ggdawanjia
薄荷健康	bohejiankang
EZCast	ezcast
中信证券	zhongxinzhengquan
一直播	yizhibo
Biu神器	biushenqi
多开分身	duokaifenshen
邮储银行	youchuyinhang
海豚手游加速器	haitunshouyoujiasuqi
寻你-趣萌贴纸视频交友	xunni-qumengtiezhishipinjiaoyou
南国今报	nanguojinbao
读报刊学英文	dubaokanxueyingwen
王者荣耀掌游宝	wangzherongyaozhangyoubao
遥控大师	yaokongdashi
平谷融媒	pinggurongmei
YY手游语音	yyshouyouyuyin
大姨妈月经期助手	dayimayuejingqizhushou
新氧医美	xinyangyimei
爱听	aiting4g
超级视力表	chaojishilibiao
梨涡	liwo
蘑菇街	mogujie
小米有品	xiaomiyoupin
涂色小画家	tusexiaohuajia
阿布睡前故事	abushuiqiangushi
咪咕灵犀	migulingxi
蔚来	weilai
工银融e联	gongyinrongelian
伊对	yiduishipinxiangqinjiaoyou
i精锐学生版	ijingruixueshengban
牛听听	niutingting
成语猜猜猜	chengyucaicaicai
小伴龙儿歌	xiaobanlongerge
粉象生活	fenxiangshenghuo
躺平	tangping
手机数据恢复精灵	shoujishujuhuifujingling
浙里办	zheliban
微商相册	weishangxiangce2
贝瓦儿歌儿童早教	beiwaergeertongzaojiao
导学号	daoxuehao
爱走路	aizoulu
猫咪大战争	maomidazhanzheng
未来之光	weilaizhiguang
随手记	suishouji
斑马会员	banmahuiyuan
薄荷阅读	boheyuedu
全历史	quanlishi
黄金钱包	huangjinqianbao
贝壳网	beikewang
米画师	mihuashi
中信银行	zhongxinbank
北京通	beijingtong
看图识字	kantushizi
七天学堂	qitianxuetang
中华英才网	zhonghuayingcaiwang
笛扬新闻	diyangxinwen
九拍陪你练	jiupaipeinilian
平安好车主	pinganhaochezhu
非人学园	feirenxueyuan
趣课多	qukeduo
弈战	yizhan
换图标	huantubiao
小影	xiaoying
市民云	shiminyun
易信	yixin
抖册视频编辑	douceshipinbianji
汤圆创作	tangyuanchuangzuo
曲奇云盘	quqiyunpan
情侣空间	qinglvkongjian
天翼超高清	tianyichaogaoqing
我的常州	wodechangzhou
盖伦国际教育	gailunguojijiaoyu
今川日语学习五十音图	jinchuanriyuxuexiwushiyintu
新浪财经	xinlangcaijing
神州租车	shenzhouzuche
可乐优品商城	keleyoupinshangcheng
快乐学堂学生端	kuailexuetangxueshengduan
学子斋课堂	xuezizhaiketang
自如	ziru
大力AI辅导-小学数学语文作业批改助手	daliaifudao-xiaoxueshuxueyuwenzuoyepigaizhushou
火花思维在线互动直播平台	huohuasiweizaixianhudongzhibopingtai
快音	kuaiyin
谷豆TV	gudoutv
看准	kanzhun
P图大神	ptudashen
易班	yiban
华数电视	huashudianshi
盛名时刻表	shengmingshikebiao
成语疯狂猜	chengyufengkuangcai
看护家	kanhujia
墨者	mozhe
他趣	taqu
梦幻西游三维版	menghuanxiyousanweiban
申万宏源大赢家	shenwanhongyuandayingjia
腾讯加速器	tengxunjiasuqi
雪球股票	xueqiugupiao
视频剪辑大师	shipinjianjidashi
小米移动	xiaomiyidong
BLUED	blued
作业答案大全	zuoyedaandaquan
旅法师营地	lvfashiyingdi
IKEA宜家家居	ikeayijiajiaju
链工宝	liangongbao
来电秀秀	laidianxiuxiu
直播吧	zhiboba
每日瑜伽	meiriyujia
云课	yunke
花生日记	huashengriji
微软必应	weiruanbiying
金币养猪场	jinbiyangzhuchang
七猫精品小说	qimaojingpinxiaoshuo
小米金融	xiaomijinrong
灯果写作	dengguoxiezuo
手抄报作业	shouchaobaozuoye
学生手机	xueshengshouji
八门助手	bamenzhushou
66铃声	66lingsheng
巧影	qiaoying
诵读帮	songdubang
陆金所	lujinsuo
接力学习	jielixuexi
乐橙	lecheng
恢复聊天记录	huifuliaotianjilu
Booking全球酒店预订	bookingquanqiujiudianyuding
PICOOC	picooc
Aloha	aloha
好分数辅导Android版	haofenshufudaoandroidban
和家亲	hejiaqin
摩玩创客	mowanchuangke
鲁能体育	lunengtiyu
abc360英语	abc360yingyu
涨乐财富通	zhanglecaifutong
国泰君安君弘	guotaijunanjunhong
志愿汇	zhiyuanhui
多来电	duolaidian
东营智慧公交	dongyingzhihuigongjiao
ECOVACSHOME	ecovacshome
个人所得税	gerensuodeshui
有书	youshu
魔玩助手	mowanzhushou
陪练蛙学生	peilianwaxuesheng
bigfun	bigfun
浦发手机银行	spdb
句读	judu
MM应用商场	mmyingyongshangchang
与你	yuni
考虫单词	kaochongdanci
一起浪	yiqilang
惠农网	huinongwang
猪迪克识字	zhudikeshizi
时光小屋	shiguangxiaowu
津心办	jinxinban
5173游戏交易	5173youxijiaoyi
个性	gexing
微脉	weimai2
省钱快报	shengqiankuaibao
快钱刷	kuaiqianshua
多锐	duorui
一起看地图	yiqikanditu
豆果美食	douguomeishi
全本免费小说阅读器	quanbenmianfeixiaoshuoyueduqi
美的美居	meidemeiju
云南移动和生活	yunnanyidongheshenghuo
围棋宝典	weiqibaodian
神墨学堂	shenmoxuetang
西语助手	xiyuzhushou
易公交	yigongjiao
永安行	yonganxing
小猴英语	xiaohouyingyu
护士加	hushijia
动动计步器	dongdongjibuqi
壁纸大全	bizhidaquan
VP电竞	vpdianjing
朴新师生	puxinshisheng
一席	yixi
大师一百	dashi100
焕彩桌面	huancaizhuomian
句子控	juzikong
叮咚买菜	dingdongmaicai
LinkedIn领英	linkedinlingying
无忧课堂	wuyouketang
线上三门峡	xianshangsanmenxia
中信银行动卡空间	zhongxinyinxingdongqiakongjian
铛铛	dangdang2
开盘啦	kaipanla
文字识别	wenzishibie
一亩田	yimutian
百分网游戏盒子	baifenwangyouxihezi
哈罗摩托	haluomotuo
BOXFiSH盒子鱼英语	boxfishheziyuyingyu
视界	shijie
江西校讯通	jiangxixiaoxuntong
得力相印宝	delixiangyinbao
Youth	youth
爱练字	ailianzi
赚点	zhuandian
学国学网	xueguoxuewang
励步启蒙	libuqimeng
小蜜单车	xiaomidanche
宜人财富	yirencaifu
博库图书馆	bokutushuguan
优路教育	youlujiaoyu
驰声听说在线	chishengtingshuozaixian
e福州	efuzhou
伴生活	banshenghuo
趣键盘	qujianpan
北京交警	beijingjiaojing
优课优信	youkeyouxin
人人代拍	renrendaipai
京东健康	jingdongjiankang
口语星球	kouyuxingqiu
vv租号	vvzuhao
普通话测试	putonghuaceshi
易字幕	yizimu
积目	jimu
炉石盒子	lushihezi
小叶子陪练	xiaoyezipeilian
GKid英语	gkidyingyu
5sing原创音乐	5singyuanchuangyinyue
五好学生	wuhaoxuesheng
环球时报	huanqiushibao
兔小贝拼音	tuxiaobeipinyin
腾讯文档	tengxunwendang
弈客围棋	yikeweiqi
掌上道聚城	zhangshangdaojucheng
Elfinbook	elfinbook
墨趣书法	moqushufa
海通e海通财	haitongehaitongcai
逸记	yiji
聚看点	jukandian
Gofun出行	gofunchuxing
gogokid英语	gogokidyingyu
壹钱包	yiqianbao
和彩云网盘	hecaiyunwangpan
讯飞有声	xunfeiyousheng
多多爱运动	duoduoaiyundong
公主涂色秀	gongzhutusexiu
花伴侣	huabanlv
杭州市民卡	hangzhoushiminka
多多动画屋	duoduodonghuawu
手机电视高清直播	shoujidianshigaoqingzhibo
水柚相机	shuiyouxiangji
1号店	yihaodian
健康160预约挂号咨询平台	jiankang160yuyueguahaozixunpingtai
外研随身学	waiyansuishenxue
运满满司机	yunmanmansiji
微商水印相机	weishangshuiyinxiangji
SUGAR苏格	sugarsuge
学海优学	xuehaiyouxue
达达	dada1
一手女装服装批发	yishounvzhuangfuzhuangpifa
中信建投证券	zhongxinjiantouzhengquan
广西人社12333	guangxirenshe12333
KK美女直播	kkmeinvzhibo
1号玩家	1haowanjia
一折特卖	yizhetemai
连尚读书	lianshangdushu
中邮钱包	zhongyouqianbao
闪艺	shanyi
尚德机构	shangdejigou
比心陪练	bixinpeilian
四川航空	sichuanhangkong
住这儿	zhuzheer
玩物得志	wanwudezhi
珍爱网	zhenaiwang
福州地铁码上行	fuzhouditiemashangxing
小黑盒	xiaoheihe
运动赚	yundongzhuan
共享师资	gongxiangshizi
钢琴教练	gangqinjiaolian
神州专车	shenzhouzhuanche
作业大师	zuoyedashi
远大小状元	yuandaxiaozhuangyuan
食行生鲜	shixingshengxian
莫莉幻想	molihuanxiang
爱南宁	ainanning
新浪邮箱	sina.mail
咿啦看书绘本故事	yilakanshuhuibengushi
游民星空	youminxingkong
小米直播	xiaomizhibo
淘知口算	taozhikousuan
猎聘	liepin
马蜂窝旅游	mafengwolvyou
手机江西台	shoujijiangxitai
美摄	meishe
好芳法课堂	haofangfaketang
希沃白板	xiwobaiban
千丁	qianding
古诗词飞花令	gushicifeihualing
环球钢琴网	huanqiugangqinwang
手机公积金	shoujigongjijin
天天酷跑	tiantiankupao
C5GAME	c5game
返利	fanli
天气	tianqi8
瓜子二手车	guaziershouche
昆山农商行	kunshannongshangxing
对啊课堂	duiaketang
玲珑加速器	linglongjiasuqi
龙光汇	longguanghui
少女与猫	shaonvyumao
盛京银行	shengjingyinxing
柚子快报	youzikuaibao
Ele学堂	elexuetang
小象优品	xiaoxiangyoupin
百合婚恋交友	baihehunlianjiaoyou
真我	zhenwo
欧可林	oukelin
i深圳	ishenzhen
出国翻译官	chuguofanyiguan
淘新闻	taoxinwen
锤子阅读	chuiziyuedu
久为优学帮	jiuweiyouxuebang
撕歌	sige
鲨鱼记账	shayujizhang
1号社区	1haoshequ
我爱我家	woaiwojia
松果出行	songguochuxing
189邮箱	189.mail
数学宝典	shuxuebaodian
Max	max
吃掉物理	chidiaowuli
海报新闻	haibaoxinwen
嘿喽运动	heilouyundong
头像大全	touxiangdaquan
时光序	shiguangxu
爱听外语	aitingwaiyu
赶考状元	gankaozhuangyuan
TalkLine	talkline
竹马法考	zhumafakao
坚果云	jianguoyun
优学猫数学	youxuemaoshuxue
海峡银行	haixiayinxing
观察者	guanchazhe
盖乐世社区	gaileshishequ
钱宝宝赚钱神器	qianbaobaozhuanqianshenqi
朴朴	pupu
蒲公英	pugongying
步天天	butiantian
1905电影网	m1905
美妆相机	meizhuangxiangji
爱山东	aishandong
全民铃声	quanminlingsheng
九江银行	jiujiangyinxing
小目标打卡	xiaomubiao
享聊	xiangliao
e钱庄	eqianzhuang
长图拼接	changtupinjie
猎鹰免费小说	lieyingmianfeixiaoshuo
河北移动	hebeiyidongheshenghuo
块时间	kuaishijian
米兔	mitu2
时光相册	everphoto
天翼生活	tianyishenghuo
欢喜斗地主	huanxidoudizhu
手机麻麻	shoujimama
掌上网咖	zhangshangwangka
智慧树	zhihuishu
4399游拍	4399youpai
魅族商城	meizushangcheng
云上恩施	yunshangenshi
派派	paipai1
看厦门	kanxiamen
中国日报	chinadaily
掌上穿越火线	zhangshangchuanyuehuoxian
王者营地	wangzheyingdi
欢游	huanyou
乐词	leci
51talk青少儿英语	51talkqingshaoeryingyu
阿卡索英语	aqiasuoyingyu
乐嗨直播	lehaizhibo
人人直播	renrenzhibo
随播	suiyuzhibo
逗游小游戏	douyouxiaoyouxi
小7手游	xiao7shouyou
和包支付	hebaozhifu
网易支付	wangyizhifu
多益战盟	duoyizhanmeng
久久语音	jiujiuyuyin
凯迪社区	kaidishequ
东方证券期货	dongfangzhengquanqihuo
PPmoney出借	ppmoneychujie
钱龙手机版证券分析软件	qianlongshoujibanzhengquanfenxiruanjian
中国银河证券	zhongguoyinhezhengquan
凡客诚品 VANCL	fanke
海狐海淘	haihuhaitao
锦江酒店	jinjiangjiudian
瑞卡租车	karuizuche
小猪一短租民宿	xiaozhu
一嗨租车	yihaizuche
个人图书馆	gerentushuguan
海尔智家	haierzhijia
秀色美女秀场	xiusemeinvxiuchang
DJ多多	djduoduo
粉粉日记	fenfenriji
凤凰金融	fenghuangjinrong
高考帮	gaokaobang
国泰基金	guotaijijin
航信帮帮	hangxinbangbang
呼呼省钱	huhushengqian
IT之家	itzhijia
凯撒旅游	kaisalvyou
六只脚户外线路	liuzhijiaohuwaixianlu
咪咕善跑	migushanpao
咪咕圈圈	miguquanquan
蜜芽宝贝	miyabaobei
拍拍贷借款	paipaidaijiekuan
全国违章查询	quanguoweizhangchaxun
手机知网	shoujizhiwang
搜狗地图	sougouditu
淘小说	taoxiaoshuo
天涯社区	tianyashequ
沃阅读	woyuedu
映客	yingke
地铁跑酷	ditiepaoku
看看视频	kankanshipin
蛙趣视频	waqu
布卡漫画	buqiamanhua
安兔兔评测	antutupingce
招商银行掌上生活	zhangshangshenghuo
买单吧	maidanba
同程旅行	tongchenglvyou
折800	zhe800
聚美优品	jumeiyoupin
途牛旅游	tuniulvyou
糗事百科	qiushibaike
驴妈妈旅游-门票.酒店.自由行.团购	lvmamalvyou
九秀直播	jiuxiuzhibo
高铁管家	gaotieguanjia
世纪佳缘	shijijiayuan
脉脉	maimai
抱抱直播	baobaozhibo
妈妈帮	mamabang
淘粉吧	taofenba
足记	zuji
DNF掌游宝	dnfzhangyoubao
贝贝	beibeiwang
8684公交	8684gongjiao
酷音铃声	kuyinlingsheng
艺龙旅行	yilong
139邮箱	139.mail
楚楚街	chuchujie
来疯直播	laifengzhibo
周末去哪儿	zhoumoqunaer
365日历	365rili
途家民宿	tujia
航旅纵横	hanglvzongheng
大麦	damaiwang
春秋航空	chunqiuhangkong
航班管家	hangbanguanjia
e代驾	edaijia
辣妈帮	lamabang
首汽约车	shouqiyueche
1药网	1yaowang
蜜疯直播	mifengzhibo
爱唱	aichang
易到	yidaoyongche
爱奇艺泡泡	aiqiyipaopao
微医	weiyi
澎湃新闻	pengpaixinwen
艾米直播	aimizhibo
悟空理财	wukonglicai
海报工厂	haibaogongchang
穷游	qiongyou
简书	jianshu
美甲帮	meijiabang
要出发周边游	yaochufazhoubianyou
对面	duimian
南方航空	nanfanghangkong
开眼	kaiyan
潇湘书院	xiaoxiangshuyuan
寺库奢侈品	sikushechipin
考试宝典	kaoshibaodian
DJ音乐盒	djyinlehe
生日管家	shengriguanjia
Nike+Running	nikerunning
豆丁书房	doudingshufang
A8体育直播	a8tiyuzhibo
租租车	zuzuche
阿基米德	ajimidefm
豆腐阅读	doufuyuedu
中国国航	zhongguoguohang
酒仙网	jiuxianwang
汽车在线	qichezaixian
天天果园	tiantianguoyuan
婚礼纪	hunliji
CCTV手机电视	shoujicctv
东方航空	dongfanghangkong
我爱卡	woaiqia
更美	gengmei
沃邮箱	woyouxiang
东方购物	dongfanggouwu
第一视频	diyishipin
大街	dajie
格林	gelinhaotai
掌上药店	zhangshangyaodian
36氪	36ke
19楼	19lou
掌上金鹰	zhangshangjinying
好好住	haohaozhu
Agoda安可达	agoda
汉口银行	hankouyinxing
财联社	cailianshe
财经杂志	caijingzazhi
大商天狗	tiangouwang
深圳航空	shenzhenhangkong
北美省钱快报	beimeishengqiankuaibao
嘟嘟直播	duduquanminzhibo
界面新闻	jiemianxinwen
百城求职宝	baichengqiuzhibao
南方周末	nanfangzhoumo
鑫财通	xincaitong
长江云	changjiangyun
新华网	xinhuawang
龙武	longwu
珍品网	zhenpinwang
电子研习社	dianziyanxishe
网易花田	huatian
爆米花视频	baomihuashipin
欢乐直播	huanlezhibo
沃音乐	woyinyue
北京银行	beijingyinxing
有妖气漫画	youyaoqimanhua
爱卡汽车	aiqiaqiche
爱豆IDOL	aidou
卡车之家	qiachezhijia
DJI大疆商城	djistore
华住酒店	huazhu
中国人寿寿险	zhongguorenshoushouxian
宝宝知道	baidubaobaozhidao
和多号	heduohao
凹凸租车	aotuzuche
必要	biyao
彩视	caishi
华安徽赢	huaanhuiying
课程格子	kechenggezi
咪咕直播	miguzhibo
中关村在线	zhongguancunzaixian
知乎日报	zhihuribao
傲世西游	aoshixiyou
百姓网	baixingwang
北京时间	beijingshijian
贝乐虎儿歌	beilehuerge
必胜客	bishengke
渤海银行	bohaishoujiyinxing
春雨医生	chunyuyisheng
电话邦	dianhuabang
凤凰FM	fenghuangfm
丰趣海淘	fengquhaitao
风行视频	fengxing
Finger	finger
海南航空	hainanhangkong
好大夫在线	haodaifu
HIGO	higo
借贷宝	jiedaibao
凯励程	kailicheng
K米	kmi
漫漫漫画	manmanmanhua
魅力惠 Glamour Sales	meilihui
美食杰	meishijie
美食天下	meishitianxia
秒拍	miaopai
飞常准	feichangzhun
买车宝典	maichebaodian
美菜商城	meicaishangcheng
天翼阅读	tianyiyuedu
洋码头	yangmatou
快递100	kuaidi100
慕课网	mukewang
17K小说	17kxiaoshuo
么么直播	memezhibo
365淘房	365taofang
参考消息	cankaoxiaoxi
斗米	doumi
链家	lianjia
搜狗号码通	sougouhaomatong
中国天气	zhongguotianqi
美味不用等	meiweibuyongdeng
国语助手	guoyuzhushou
卷皮折扣	juanpizhekou
大话西游（合集）	dahuaxiyou
波奇宠物	boqichongwu
热血江湖	rexuejianghu
蜀门手游2	shumenshouyou
敢达争锋对决	gandazhengfengduijue
征途22	zhengtu2
梦幻花园	menghuanhuayuan
武林外传	wulinwaizhuan
千帆直播	qianfanzhibo
石榴直播	shiliuzhibo
喵播美女直播	miaobomeinvzhibo
WTV影视大全	wtvyingshidaquan
9158美女直播	9158meinvzhibo
我秀娱乐直播	woxiuyulezhibo
热猫直播	remaozhibo
苏宁金融	suningjinrong
江苏银行	jiangsuyinhang
微爱	weiai
腾讯自选股（腾讯官方炒股软件）	tengxunzixuangu
飞贷	feidai
度小满金融	duxiaomanjinrong
时光网	mtime
果壳精选	guokejingxuan
粉丝网	fensiwang
行者	xingzhe
豆瓣阅读	doubanyuedu
安卓读书	anzhuodushu
爱动漫	aidongman
ZAKER新闻	zakerxinwen
免费小说全集	mianfeixiaoshuoquanji
NGA玩家社区	ngawanjiashequ
百度Hi	baiduhi
咪咕影院	miguyingyuan
海岛奇兵	haidaoqibing
欢乐麻将	huanlemajiang
2345浏览器	2345liulanqi
违章查询助手	weizhangchaxunzhushou
应届生求职	yingjieshengqiuzhi
网上厨房	wangshangchufang
智通人才网	zhitongrencaiwang
蚂蚁财富	mayicaifu
首旅如家	shoulvrujia
熊猫出行	xiongmaochuxing
钓鱼人	diaoyuren
安心记加班	anxinjijiaban
微差事	weichaishi
恒房通	hengfangtong
泼辣修图	polaxiutu
云之家	yunzhijia
安智市场	anzhishichang
触手直播	chushouzhibo
360浏览器	360liulanqi
融360	rong360
相机360	xiangji360
纵横小说	zonghengxiaoshuo
微车违章查询	weicheweizhangchaxun
战旗直播	zhanqizhibo
龙珠直播	longzhuzhibo
看漫画	kanmanhua
魂斗罗：归来	hundouluoguilai
LOL掌游宝	lolzhangyoubao
365日历	365rili
乐秀视频剪辑视频编辑	lexiushipinjianjishipinbianji
约单	yuedan
拉卡拉	lakala
发型屋	faxingwu
免费全本小说书城	mianfeiquanbenxiaoshuoshucheng
新华社	xinhuashe
聊聊	liaoliao
中粮我买网	zhongliangwomaiwang
和生活	heshenghuo
快读全本小说	kuaiduquanbenxiaoshuo
巴士管家	bashiguanjia
太平洋汽车	taipingyangqiche
火猫直播	huomaozhibo
炉石传说掌游宝	lushichuanshuozhangyoubao
呱呱财经	guaguacaijing
优购时尚商城	yougoushishangshangcheng
小咖秀	xiaokaxiu
链家	lianjia
淘宝电影	taopiaopiao
招联金融	zhaolianjinrong
玖富万卡	jiufuwanka
腾讯游戏助手	tengxunyouxizhushou
妈妈社区	mamashequ
启信宝-企业信用查询	qixinbao
宝宝树孕育	babytree
花粉俱乐部	huafenjulebu
网易邮箱大师	wangyiyouxiangdashi
淘最热点	taozuiredian
51信用卡管家	51xinyongkaguanjia
掌证宝理财交易软件	zhangzhengbaolicaijiaoyiruanjian
看漫画	kanmanhua
广西移动和掌桂	guangxiyidonghezhanggui
优健康	youjiankang
红人装	hongrenzhuang
爱上街	aishangjie
省省回头车	shengshenghuitouche